Pokorny_entry	English_gloss
ā	(an exclamation)
ab-	water, river
ā̆bel-, ā̆bō̆l-, abel-	apple
abh-	swift, quick, abrupt
abhro-	strong, mighty
abō(n)	ape, monkey
1 ad-	at, by, to
2 ad-	to fix, put in order
ades-, ados-	spelt (type of grain)
ad(u)-, ad-ro-	current, water course
ag̑-	to lead, drive, agitate
ā̆g̑-	goat
ag̑h-	animal that may bear young
ā̆g̑her-, ā̆g̑hen-, ā̆g̑hes-, or ō̆g̑her etc.	day, dawn
agh-	to ail, fear, be depressed
agh-(lo-)	disgusting, unpleasant
aghl(u)-	dark cloud; rainy weather
agos-	sin, guilt; fault, blemish
agro-, egro-?	first, highest; apex, beginning
ag̑ro-s	field, acre
agu̯(e)sī, aksī	axe
agu̯h-no-s	lamb
1 ai	(an exclamation)
2 ai-	to drive, close in; harm, overwhelm
3 ai-	to give
ai-ti-, ai-to-, oi-to-	part, portion
4 ā̆i-	to burn, shine
5 ai- : oi-	oath, significant speech
aid-	to swell; strong
ai-dh-, i-dh-, nasalized i-n-dh-	to burn, shine
ā̆ier-, ā̆ien-	day(light), morning
aig̑-	goat
1 aig-, nasalized ing-	ill, sick; depressed, dispirited
2 aig-	oak
3 aig-	to swing, vibrate, move violently
aigu̯h-	to be ashamed
ā(i)g̑h- : īg̑h-	to need, desire
ā̆ik̑- : ī̆k̑-	pike, spear, spit
aik-	to call to
ai̯os-	ore, metal (copper, bronze, iron)
ai-rā	(type of grass)
1 ais-	to wish, desire, ask/search for
2 ais-	to respect, worship, be in awe
aisk-	clear, bright, shining
ai-tro-	sharp, bitter
aiu̯-, ai̯u-	vitality, life force
1 ak̑-, ak̑ō-	to eat
2 ak̑-, ok̑-	sharp, acute, angular; stone
akkā	mama (nursery word)
ak̑ru	tear(drop)
aku̯-	to hurt, damage
aku̯ā-, more accurately əku̯ā, ēku̯-	aqua, water, river
1 al-, ol-	beyond; other, alien
2 al-	to grow, nourish, enhance
3 ā̆l-	to roam, wander; be crazy/confused
4 al-	to burn
5 al-	to mill, grind
6 al-, alōu- : aləu-	white, gleaming
alā	hello! (greeting)
albhi-	barley
albho-	white, albino
aldh-	trough
aleq-	to protect, ward off
algh-	cold, frost, algidity
algu̯h-	to gain, earn; price, value
alp-	small, weak
ālu-, ālo-	a bitter plant?
alu-, alu-d-, alu-t-	bitter; ale, beer
ambhi, m̥bhi	around, at both sides
1 am-, mē-	to grab, seize
2 am-, mē-	to mow
āmer-, āmōr, āmr̥	day
ames-, or omes-	blackbird: merl, ousel
amə-	to proceed energetically; firm up; suffer
am(m)a, amī̆	mama, amah (nursery word)
1 an-	relative, ancestor
2 an-	there, other side
3 an(ə)-	to breathe, respire, animate
4 an-, anu, anō, nō	on, along, over there
andh-, anedh-	to sprout, bloom, blossom; herb, anther
andher-, ṇdher-	stem, spike
andho-	blind, dark, somber
anət-	duck, solan
anətā, enətā	anta, doorpost
ang̑h-	tight, narrow, anguished; to constrict
ang̑hen-	scent, smell, odor; person
angu̯(h)i-	eel, worm, snake, serpent
1 ank-	force; need, necessity
2 ank-, ang-	to flex, bend, angle
āno-	ring, annulus
ans-	favorable, well inclined
ansā, ansi-	noose, snare; ansa, handle
ansu-, ṇsu-	ghost, spirit, demon
ant-s	brow, front, anterior
antro-m	cave, hollow
1 ap-, more accurately əp- : ēp-	to take, reach, grasp
2 ā̆p-	water, river
3 ap-, āp-	old, fragile; harm, damage
appa	papa (nursery word)
apelo-	strength
āpero-	shore, bank (of river)
apo-, pō̆, ap-u, pu	off, out of, away from
apsā	aspen (tree)
1 ar-, thematic (a)re-, heavy-base arə-, rē-, and i-base (a)rī̆-, rēi-	to fit, suit
2 ar-, or er-	to share, distribute
3 ar-	nut
4 ar, er, or?, r̥	now, therefore; (interrogative particle)
5 ar-	to deny, refuse, renounce
ar(ə)-	to ear, plow
ardh-	pole, stake
ardi-, r̥di-	tip, point, edge
areg-	to lock, shut away
ar(e)-g̑-, arg̑-?, r̥g̑i-	white, argent, glittering
areq-	to lock, guard, protect
arenko-	(type of grain?)
ario-?	host, lord, master
arqu-	arc, arch, something bent
arōd-, arəd-	(type of waterbird)
aro-m	reed?
aru̯ā	intestines?
ā̆s-, based on it azd-, azg(h)-	to burn, glow; ash
ast(h)-	bone
at-	to go; year, annum
āt(e)r-	fire
*ati-, ateli-	(type of fish)
ati, ato-	over, beyond
ā̆tos, atta	daddy, mommy (nursery word)
1 au-	ow! (exclamation of pain)
2 au-, au̯-es-, au-s-	to sleep, stay overnight
3 au-, au̯e, u̯ē̆-	down, away from
4 au-, u- : u̯ē̆-, u̯o-	other; that (one)
5 au̯-, au̯ē-	to plait, weave
6 au̯-, au̯ed-	to speak
7 au̯-, au̯ē-, au̯ēi-	to like, help
8 au̯-, au̯ēi-	to perceive, understand, be aware of
9 au̯(e)-, au̯ed-, au̯er-	to wet, flow, sprinkle; water, river, etc.
10 au̯(e)-, au̯ē(i)-, u̯ē-	to vent, blow
11 au̯ē-, (u̯e-d(h)-?)	to strain, take pains
au̯eg-, u̯ōg-, aug-, ug-	to augment, increase, magnify
au̯ei-, əu̯ei-?	bird, avifauna
au̯es-	to shine
aug-	to shine, gleam, glitter
augh-, ugh-	nape of the neck
au̯ig̑-	oats; type of grass
auqu̯(h)- : uqu̯(h)-, probably also u̯equ̯(h)-	cooking pot
au-lo-s : ēu-l-	tube, pipe, aulos
au̯o-s	maternal grandfather
aus-	to draw (water); scoop, ladle
baˣb-, bhaˣbh-, paˣp-	to swell
baba-	babble, babbling, unclear speech
badi̯os	bay, brown; gold, yellow
baitā, or paitā?	goatskin; cloak, mantle
bak-	stick, staff; to hit, peg
bal-, balbal-	to dance, shake, whirl
bal-bal-	babbling, unclear speech
baˣmb-	(type of noise)
baˣmb-, bhaˣmbh-, paˣmp-, phaˣmph-	to swell
band-	drop (of liquid)?
bar-bar-	babbling, unclear speech
bata-	babble, murmur, meaningless stuttering
bau	bow-wow (onomatopoeic: dog barking)
bdel-	to suck
bē, bā	baa (onomatopoeic: sheep bleating)
bed-	to swell
1 bel-	to cut off, cut out
2 bel-	strong
bend-, bṇd-no-	spike, needle, tip jutting out
1 b(e)u-, bh(e)u-	(onomatopoeic: dull noise)
2 b(e)u-, bh(e)ū̆-	to boil, swell, puff up
bis-(t)li-	gall
blat-	to chat, prattle
blē-	to bleat
blou-, bhlou-?, plou-	flea
bol-	bulb, tuber
brangh-, brongh-?	hoarse?
breuq-	to jump
bronk-	to lock, shut in
bu-	lip; kiss, buss
1 bhā-, bhō-, bhə-	to shine, glisten
2 bhā-	to speak
bhabhā	bean
bhā̆d-	good, better
1 bhag-	to divide, apportion
2 bhag-	sharp
bhāgó-s	beech (tree)
bhā̆gh-	bog, swamp, lowland
bhāg̑hú-s	elbow, forearm
bhar- : bhor- : bhr̥-	burr, stubble; something jutting out
bharu-	(fir) tree, forest
bhares-, bhores-	point, bristle, stubble (with formants)
bhardhā	beard
bhareku̯-, or bhereku̯-	to farce, stuff full
bhares-	barley
bhasko-	heap, bundle, fascicle
bhāso-, or bhēso-	(large bird of prey)
bhāt- : bhət-	to bat, hit
1 bhā̆u- : bhū̆-	to hit, beat
2 bhāu-	to shine, glisten
1 b(h)e, and b(h)eg̑h	beside, outside, without
2 bhē̆, bhō̆	(emphatic particle)
bhē-, bhō-	to warm, bake, roast, fry
bhebhru-, bhebhro-	glittering; bright brown
1 bhedh-	to dig, stab, pierce, embed
2 bhedh-	to flex, bend, crook
bheg-, bheng-	to bang, break, smash
bhēgh- : bhōgh-	to resist, dispute
bhegu̯-	to flee, run away
bhei-	bee (insect)
bheid-	to bite, prick, pierce, split
1 bheidh-	to force; advise, confide, encourage
2 bheidh-	to bind, plait
bhei(ə)-, bhī-	to hit
bheigu̯-	to shine, glitter?
1 bhel-, Balto-Slavic also bhelə-	glittering white
2 bhel-	henbane
3 bhel-, bhlē-	to grow, spread, swell, inflate
4 bhel-, and bhlē-, bhlō-, bhlə-	leaf, foil, blade; bloom
5 bhel-, chiefly with suffixes: bheləg̑-, bhelə-n-g̑-, bheleg̑-, bhl̥k̑-	balk, beam, rafter
6 bhel-	to speak, bell, bellow, resound
bh(e)lāg-	weak, silly, ridiculous
bheld-	to hit, poke
bheleg-	to shine, glisten
bheleu-	to hit, weaken; ill, weak
bhelg̑h-	to swell, bulge, billow
bhen-	to hit, wound
bhend-	to sing, rejoice
bhendh-	to tie, bind
bheng̑h-, bhn̥g̑h-, adj. bhn̥g̑hú-s	fat, thick, dense
1 bher-	to bear, bring, carry
2 bher-	to boil, swell, well up
3 bher-	to bore, cut, scrape, use sharp tool
4 bher-	to hum, buzz
5 bher-	shining; bright brown
6 bher-	to cook, bake, fry, roast
7 bher-	to plait, weave
bheredh-, bhṛdho-	to cut; board
bhereg-	(onomatopoeic: to bark, cry, roar, etc.)
bherəg̑-, bhrēg̑-	to shine; bright, white
bhereg̑h-, bherg̑hos-	high, noble; barrow, mountain
bherək̑-, bhrēk̑-	to shine, glitter
1 bherem-	to stand out; brim, edge, hem
2 bherem-	to hum, buzz, drone
bheres-	quick, festinate
bh(e)reu- : bh(e)rū̆-	to brew, boil, surge, be wild
bherg̑h-	to keep, hide, bury
bherug-, bhrug-, bhorg-	throat
1 bhes-	to spread, smear, rub on
2 bhes-	to blow, breathe
bheu-, bheu̯ə-, bhu̯ā-, bhu̯ē- : bhō̆u- : bhū-	to be, exist; grow, prosper
bheudh-, nasalized bhu-n-dh-	to awaken, be aware
1 bheug-	to flee, escape, seek refuge
2 bheug-, bheugh-	to free, put away
3 bheug-, bheugh-	to bow, flex, bend, crook
4 bheug-	to enjoy
bhidh-	pot, vat, cauldron
bhili-, bhilo-	good, friendly, harmonious
bhlag̑-	to hit, flog, flail
bhlagh-men-	priest, flamen, wizard
bhlē-	to bleat, weep, howl
bhlē̆d-, bhl̥d-	to boil, bubble up; boast, chatter
bhlegu̯-	to swell, become bloated
1 bhlē̆i- : bhləi- : bhlī-	to shine, glitter
2 bhlei-	to swell, burst, blow up
bhlē̆ig̑-, bhlīg̑-	to shine, glitter
bhleiq-	to shine, glitter
bhlendh-	dim, pale, blond, reddish
bhles-	to shine, glitter
bhleu-	to bloat, swell, blow up; flow
1 bhlēu- : bhləu- : bhlū-	to shine, glitter
2 bhlēu- : bhləu- : bhlū-	bad, weak, miserable
bhleu-(k-)	to burn
bhlē-u̯o-s	a light color (blue, yellow)
bhleus-	mild, weak
bhləido-s	pale, light
bhlīg̑- : *bhlēig-	to hit, strike, inflict
bhlō̆k-	flock, tow, wool; cloth?
bhlos-q-	(onomatopoeic: to bark, cry, roar, etc.)
bhog-	beck, flowing water
bhō̆gh-, or bhā̆gh-	bog, swamp, lowland
bhōi- : bhəi- : bhī-, bhii̯ə-	to fear, be afraid
bhok-	to burn?
bholo-	mist, smoke, steam?
bhorgu̯o-s	gruff, unfriendly
bhoso-s	bare, naked
bhoudhi-	victory
bhouku̯os	a buzzing insect
bhrag-, better bhrə-g-	to scent, smell
bhrā́ter-	brother, family member
bhred(h?)-	to wade, wander
1 bhreg̑-	to break
2 bhreg̑-	to stick up
bhrēi-, bhrī̆-	to fray, pierce, cut with sharp tool
bhren-	to bulge, stick out; edge, brink
bhrendh-	to sprout, swell up
bhrenk-, bhronk-	to bring
bhre(n)k̑-	to err, be ensnared
bhren-to-s	deer, horned animal
bhres-	to burst, break
bhreu-, bhreu-d-	to swell, sprout
1 bhrē̆u-, bhrū̆-	to break, cut, pierce
2 bhrēu-, bhrū-	edge
bhreu-k̑-	to strike, throw
1 bhreu-s-	to swell, sprout
2 bhreu-s-	to bruise, break to pieces
3 bhreus-, bhrū̆s-	to boil, sound, etc.
bhroisqo-, bhrisqo-	bitter
1 bhrū-	brow, eyebrow
2 bhrū-, bhrēu-	beam, bridge
bhrūg-	fruit; to brook, enjoy
bhrugh-no-	twig
bhudh-m(e)n	base, ground, bottom, fundament
bhū̆g̑o-s, familiar form bhukko-s	buck, goat
dā-	fluid; river; to flow
dā : də-, and dāi- : dəi-, dī̆-	to share, divide
dāiu̯ēr, genitive daiu̯rés	brother-in-law
dak̑ru-	tear (from the eye)
dāu-, dəu-, dū̆-	to burn, injure, torment
*dəg̑h-mó-	slanting
de-, do-	I-deictic; here
dē- : də-, and dēi-, dī-	to tie, bind
dēg-	to take, grab, pack?
1 dei-, dei̯ə-, dī-, di̯ā-	to shine, glitter; day, sun; god, deity
2 dei̯ə-, di̯ā-, di̯ə-, dī-	to move, spin, swing
deig̑h-	to itch, prick; tick
deik̑-	to teach, show
1 dek̑-	to take
2 dek̑- : dok̑-, dēk̑-	to tear, rip to pieces
dek̑m̥, dek̑m̥-t, dek̑u-	ten, decade
1 del-	to tell, count, calculate
2 del-	to shake, totter
3 del-, dol-, delə-	to split, divide
4 del-	to rain, dribble
5 del-	long
dem-, demə-	to build, timber; house, domicile
demə-, domə-, domə-	to tame
demel-	worm?
denk̑-	to bite
1 dens-	to learn; mental power
2 dens-	dense
deph-	to push, stamp, thrust
1 der- : dōr-, der-, or dōr- : dər-	hand span
2 der-, reduplicated der-der-, dr̥dor-, broken reduplication dor-d-, dr̥-d-	(onomatopoeic: to mutter, grumble)
3 der-, drā-, dreb-, drem-, dreu-	to run, trip, tread, tramp
4 der-, heavy-base derə-, drē-	to cut, skin, split, tear
derbh-	to wind, put together
der(ep)-	to see?
derə-, drā-	to work
dergh-	to grasp
derk̑-	to look
deru-, dō̆ru-, dr(e)u-, drou-, dreu̯ə- : drū-	firm, solid; tree, wood
des-, dēs-	to find
1 deu-	to sink in, plunge into
2 deu-, or dou- : du-	to worship, venerate; mighty
3 deu-, deu̯ə-, du̯ā-, dū-	to pass, move forward
deuk-	to tug, pull, drag, tow
deup- : kteup-?	(onomotopoeic: dull thud)
dəg̑h-mó-s	slanting
digh-	goat
dī̆p-ro-, dī̆p-erā	sacrificial animal
dl̥kú-	sweet, dulcet
dn̥g̑hū, dn̥g̑hu̯ā	tongue
dō- : də-, also dō-u- : dəu- : du-	to give, donate
dous-	arm
drē- : drə-, extended dr-ē̆m-	to sleep
dreg̑h-	vexed, displeased, unwilling
dumb-, dumbh-?	tail, penis
dus-	bad, foul, evil
du̯ei-	to fear
du̯ō(u)	two, duo
1 dhā̆bh-, nasalized dhamb(h)-	to be speechless, astonished; to dab, be touched, affected
2 dhabh-	to fix, suit; proper
dhā̆l-	to bloom, be green
dhanu-, or dhonu-	(type of tree)
dhau-	to press, strangle
1 dhē-, reduplicated dhē-dh(ē)-	older family member (nursery word)
2 dhē-	to do, put, place, set
3 dhē-, dhə-	to disappear, pass away
dheb-	fat, thick, heavy
dhebh-, dhebh-eu-	to harm, injure
dhegu̯h-	to burn
dhē(i)-, also dh-ei-?	to suck, suckle
dhei̯ə- : dhi̯ā- : dhī-	to look, see, show
dhēigu̯- : dhōigu̯- : dhīgu̯-	to dig, plant, stab, stick
dheig̑h-	to build, knead clay
1 dhel-, dholo-	curve; dell, hollow
2 dhel-	to light; shining
3 dhel-	to tremble
dhelbh-	to dig, delve, bury
dhelg-	to stab, stick; needle
dhelgh-, dhelg-	to hit
dhem-, dhemə-	to blow, fly about like dust
dhembh-, dhm̥bh-	to dig
1 dhen-	to flow, run
2 dhen-	flat of hand, surface of land, etc.
3 dhen-	to hit, ding, push, thrust
1 dhengh-	to press, cover
2 dhengh-	to get, grip, reach
1 dher-, dherə-	dirt, dreg, some type of deposit
2 dher-, dherə-	to hold, support
3 dher-, dhereu-, dhrē̆n-	(onomatopoeic: to drone, growl, purr, etc.)
4 dher- : dhor- : dher-	to jump (at)
5 dher-, dhrei-d-	to defecate; dirt
dherāgh-	to drag, pull
dherbh-, dherəbh-?	to work
dherebh-	to harden; coagulated
dheregh-	bushy plants
dhereg̑h-, dhr̥g̑h-nā-	to turn, wind
dhers-	to dare, be bold
dhēs-, dhəs-	(used in religious terms)
1 dheu-	to flow, run
2 dheu-, dhu̯-ēi-	to die, faint, vanish
3 dheu-	to shine brightly
4 dheu-, dheu̯ə-, presumably dhu̯ē-, compare suffixes dhu̯ē-k-, dhu̯ē̆-s-	to blow, dissipate, fly about like dust, etc.
dheu-b-, dheu-p-	deep, hollow
dheubh-, dhubh-	peg, wedge
dheu̯es-, dhu̯ē̆s-, dheus-, dhū̆s-	to blow, dissipate, fly about like dust, etc.
dheugh-	to milk, press, touch
dhlas-, or dhels- : dhl̥s-	to press, squeeze; squash?
dhl̥gh-	debt, guilt, duty
dhō-	to sharpen
dhō[u]- : dhū-	rope?
dhrebh-	to drub, crush, grind to pieces
dhreg̑-	to pull
1 dhregh-	to run
2 dhregh-	to hurt, torment
dhreibh-	to drive, push, thrust
dhreu-	to grind, crumble
1 dhreugh-	to shake, tremble
2 dhreugh-	to harm, deceive
dhrigh-, or dhreikh-	hair, bristle
dhrono-	multicolored?
dhug(h)əter-	daughter
dhu̯en-, dhun-	to hum, drone
dhu̯er-, dhu̯erə-	to harm by trickery/deception
dhu̯ē̆r-, dhu̯ō̆r-, dhur-, dhu̯r̥-	door
dhu̯ergh- : drugh-	crippled, dwarf-like, low in stature
1 ē̆, ō̆	(particle: he, this, etc.)
2 ē, ō	oh (vocative interjection)
3 e-, ei-, i-, fem. ī-	(demonstrative particle: one, this, etc.)
ebhi? : obhi : bhi	from, around, (up) to, etc.
ed-	to eat
1 edh-	tip, point
2 edh-	fence of stakes
eg-	lack (of something)
ēg̑-, ōg̑-, əg̑-	to say, speak
eg̑-, eg̑(h)om, eg̑ō	ego, I (pronoun)
eg̑hero-	(inland) lake
eg̑hi-	hedgehog
eg̑hs, eg̑hz	from, out of, ex-
egnis : ognis	fire
ehem, eheu, eho	aha! oho! (exclamation)
1 ei-	to go, exit
2 ē̆i	O (vocative particle)
3 ei-	bright; reddish
4 ei- : oi-	pole, stake
eibh- : oibh-, i̯ebh-	to copulate
eig-, oig-	to lament, complain
ēik-	to own, possess, be capable
1 eis-	to move rapidly/violently
2 ei-s-, ei-n-	ice, frost
ek̑u̯o-s	horse
1 el-, ol-, el-	red, brown
2 el-	to lie, recline
3 el- : ol-	to rot, be moldy
4 el-, ol-	(a noise)
5 el-, ol-	to destroy
6 el-, elə- : lā-, el-eu-(dh-)	to go, move, drive
7 el-, elə-, with k-suffix elk-, elək-	hungry; bad?
8 el-, elē̆i-, lē̆i-, olī̆nā	to bend; elbow
ēl-	line, strip
ēlā	awl, bodkin
elg-	poor, needy
elk-, elək-	hungry; bad?
elkos-	boil, abscess
em-	to take
embhi-, empi-	bee, gnat, mosquito
1 en	in
2 en-	year
ēn	behold! look here!
1 enebh-, embh-, ombh-, nō̆bh-, nēbh-?, m̥bh-	navel
2 enebh- : nebh-, embh-, m̥bh-	wet, damp; cloud, nimbus; water
enek̑-, nek̑-, enk̑-, n̥k̑-	to reach, obtain
ē̆neu, ē̆nu	without
e-neu̯en, neu̯n̥, enu̯n̥	nine
engu̯-, n̥gu̯ḗn	bump, swelling
eno-, possibly e-no- : ono- : no- : -ne-	that
en(o)mn̥-, (o)nomn̥, nōmn̥	name
enos-, or onos-	onus, burden
enq-, onq-	to sigh, groan
ent-, better ant-?	to weave
epero-	wild boar
epi, opi, pi	at, near, epi-
ēpi-	comrade, companion
epop, opop	(onomatopoeic: call of hoopoe bird)
eph-	to cook
1 er-, or-	erne, eagle
2 er-, eri-	goat, sheep
3 er- : or- : r-	to move, set in motion
4 er-, er-t-, er-u̯-	earth
5 er-, erə-, thematic (e)r-ĕ-	loose, crumbly
ereb-, orob-, rōb-	to drill, make holes, hollow out
ē̆reb(h)-, ō̆rob(h)-	(dark color, reddish brown)
ered-	to flow away; dampness
eregu̯(h)o-, erogu̯(h)o-	pea, legume
1 erek-, er[e]gh-	tick, mite, louse
2 er(e)k-, rek-, rok-	to tear, cut, split
1 eres-	to stab, pierce
2 ere-s-, ers-, r̥s-, eres-, and rē̆s-, rō̆s-	to flow
1 ereu-	to ask, seek
2 ereu-	to tear, rip up
1 erə-, rē-, er(e)-	to row; oar
2 erə-, rē-	to rest, be still
er(ə)d-, (er(ə)d-), er(ə)dh-	high; to grow
ergh-	to shake, tremble
erku̯-	to beam, shine; to praise
ers- : orsos	tail; arse, rump, backside
es-	is, to be
esu-s : su-	good, able
ē̆s-	to sit
es-en-, os-en-	summer, harvest time
ē̆s-r̥(gu̯), genitive es-n-és	blood
et(e)n-	seed, grain
ēter-	intestines
eti	out, beyond, etc.
ētī-	eider (duck)
ēt-mén-	breath
ētro-	quick, swift, hurried
1 eu-, euə- : u̯ā-, u̯ə-	to lack, want; empty, vacant
2 eu-	to dress, put on
3 eu-	to feel
4 eu-	(exclamation of joy)
ēudh-, ōudh-, ūdh-	udder
euk-	to accustom oneself, be used to
eus-	to burn
eu̯egu̯h-	to praise, worship, avow, speak formally
g̑ā̆b-	to show, watch out for
gag-, gōg-	something round/lumpy
1 gal-	bald, callow, naked
2 gal-	to call, cry
3 gal-, or ghal-	to be able
gan(dh)-	vessel
gang-	to mock, scorn
g̑ā̆r-	to call, cry
garəg̑-	grim, grievous, dreadful
gāu-	to rejoice, be glad
g̑ebh-	bough, branch, stick
g̑egh-, g̑ogh-	branch, bush; picket
gei-	to bend, turn
gē(i)- : gō(i)- : gī-	to cry, sing
g̑ēi-, g̑ī-	to sprout
geid-	to stab; kittle, tickle
g̑eid-	to suck
geig̑-	to bite, prick, stab
g̑eis-	gravel
1 gel-	to curl, form into ball; round
2 gel-, and gu̯el-	to glut, devour, envelop
3 gel(ə)-	cool, cold; to keel, freeze
g̑el-, g̑elə-, g̑lē-, also *gelēi- : g̑(e)ləi-	bright; to shine, be joyful
gelebh-	to flay, scrape
geli-, glī-	mouse
g̑(e)lōu̯-	sister-in-law
gem-	to grasp, grip; be full
g̑embh-, g̑m̥bh-, g̑ombhos	to bite; tooth
g̑em(e)-	to marry
gen-	to pinch, press together, etc.
1 g̑en-, g̑enə-, g̑nē-, g̑nō-	to bear, produce, generate
2 g̑en-, g̑enə-, g̑nē-, g̑nō-	to ken, know, recognize
genebh-, genobh-	pin, wooden plug
geng-, gong-	lump
gengh-	to turn, weave
1 g̑enu-, g̑neu-	knee, joint
2 g̑enu-, fem., g̑enədh- : g̑onədh-	chin, jaw(bone)
g̑ep(h)-, g̑ebh-	jaw, jowl, mouth; to eat
1 ger-, gere-	to cram, collect, put together
2 ger-	(onomatopoeic: to crow, shriek, etc.)
3 ger-	to turn, wind, curl
4 ger-, grēi-	to grow, awaken
g̑er-, g̑erə-, g̑rē-	to rub; rotten; to age, ripen; grain
gerebh-	to carve, scratch; write
g̑ers-	to bend, turn
gēu-, gəu-, gū-	to bend, curl; cup, vessel
g̑eu-, g̑eu̯ə-, also geu̯ə-	to hurry, promote
g(e)u-lo-	glowing coal
g̑eus-	to taste, degust, enjoy
g(i̯)eu-, g̑(i̯)eu-	to chew
glag-, or glak-	milk
gleg̑-	soft, tender
g̑lei-	to attack, run at
gleubh-	to cut, cleave, pare, slice
glōgh- : gləgh-	barb, spike
1 gol-, lengthened grade gōl-, reduced grade gol-	to camp, lie down; den (of animals)
2 gol-	bough, branch, twig
gō̆u-, gou̯ə-, gū-	to call, cry
gou̯ə-, or gau̯ə-? : gū-	hand; to grab
gras- : grō̆s-	to gnaw, eat, devour
grēb(h)o-s : grōb(h)o-s	beech or hornbeam (tree)
gred- : grod-	to grate, scratch
grem-	to be damp; to sink
1 greus-	to crush, crumble, crackle
2 greus-	to burn, smolder
greut-	to crush, press; curd
grōd-, grəd-	hail?
gru-	to grunt (of pigs)
gha gha, ghe ghe, ghi ghi	to cackle, gaggle (of geese)
ghabh-	to take, grab, seize
ghabh(o)lo-, masc., ghabh(o)lā fem.	branch, fork
g̑hāgu̯h-	young bird/animal
ghaido-, or g̑haido-	goat, kid
ghais-	to stick, be fixed to
g̑haiso-, or g̑həiso- : g̑hēiso-	dart; staff, stick
ghait-ā	curly/wavy hair
g̑hal-, g̑hal-ar-	flaw, defect; harm
g̑halg(h)-	flexible twig
g̑han-	to yawn
g̑han-s-	goose
1 g̑hasto-, g̑hazdho-	pole, rod, gad; twig
2 g̑hasto-	arm, hand
g̑hau-, g̑hau̯ə-	to call
ghau̯o-	FALSE
g̑hðem-, g̑hðom-, genitive-ablative g̑h(ð)m-és	earth, ground, soil, humus
g̑hði̯és, zero-grade g̑hðis, simplified to g̑hðés, g̑hi̯és, g̑hés	yesterday
g̑hðū-, or g̑hi̯ū-?	fish, ichthyoid
ghe-, gho-	(enclitic (emphatic?) particle)
1 g̑hē-, g̑hēi-	to lack, be empty; leave, go out
2 g̑hē- : ghə-, and g̑hēi- : g̑hī-	to gape, yawn
ghebh-el-, ghebh-el-, ghebh-elo-	gable, head
ghed-	to defecate; hole, opening
ghedh-, ghodh-	to join, unite, gather, make a bond
ghegh-	to bend, curve
g̑(h)eg̑h-	ferret (or similar carnivorous mammal)
1 g̑hei-, g̑hēi-	to goad, drive; to throw, wound
2 g̑hei- : g̑hi-	snow; winter
gheidh-	to desire, yearn for
gheig̑h-	to desire, yearn for
gheis-, and g̑heiz-d-	shocked, aghast, confused
ghel-	to yell, call, cry
1 g̑hel-, and ghel-?, also as i-, u-, or n-stem; g̑helə-, g̑hlē-, g̑hlō-, g̑hlə-	to shine, glare, glow; gold, yellow, bright color
2 g̑hel-	to cut?
g̑hēlā	wine?
gheldh-	to desire, wish for
ghel(ē̆)g̑h-	(type of metal)
gheləd-	hail, ice
ghelg̑h-	gland
ghel-ond-, ghol-n̥d-	stomach, intestines
ghel-ōu-, ghelū-	turtle, tortoise
ghel-tō, Germanic and ghel-dhō Slavic	to cost, pay, be worth
ghelunā	jaw, gill
ghen-	to grind, crack open, gnaw to pieces
ghend-, and ghed-	to get, grasp, seize
ghendh-, ghondh-	boil, abscess
g̑hengh-	to step, stride, march
1 gher-	(onomatopoeic: to snarl, rattle, etc.)
2 gher-	to rub, stroke hard
3 gher-, ghrē- : ghrō- : ghrə-	to come out, jut out
1 g̑her-	to desire, yearn for
2 g̑her-	to gash, slit, scrape, scratch
3 g̑her-, and g̑herə-, g̑hrē-	to beam, shine, shimmer
4 g̑her-	to grab, grip, seize
5 g̑her-, g̑hor-nā	bowels
6 g̑her-, g̑herə- : g̑hrē-?	short, small
7 g̑her-	to stiffen, stand out
g̑herdh-, and gherdh-	to gird, enclose, encompass
1 ghers-, ghres-	horror, disgust, revulsion
2 ghers-	(type of weed, e.g. goat's foot)
g̑hers-	to stiffen, bristle, stand out
gherto-	milk, butter
g̑herzd(h), genitive g̑hr̥zd(h)-es, g̑herzdā	barley, prickly grain
g̑héslo-	thousand, chiliad
g̑hesor-, g̑hesr-	hand
g̑hesto-	arm, hand
1 g̑heu-	to gush, pour, found
2 g̑heu-, g̑heu-d-	to die, disappear, get away
g̑hēu- : g̑hō(u)- : g̑həu-	to gape, yawn
gheub(h)-	to bend, move
gheug̑h-, ghū̆g̑h-	to conceal, do secretly
gheu̯ei̯ā, g̑heu̯ei̯ā	pit, hollow
ghlādh-	bright, brilliant
g̑hlād-	to call, sound
ghleu-	to be happy, joyful, gleeful
g̑hō	behind; towards
ghoilo-s	foaming, turbulent, frothing up
ghom-	stall
ghō̆s-	to eat
ghosti-s	guest, stranger
ghou̯(ē)-	to gawk, be aware of, pay attention to
ghou-ro-s	frightened, frightening
ghous-	to sound, hear
ghrē- : ghrō- : ghrə-	to grow, become green
1 ghrebh-, gherbh-, root extension ghrebhā-	to grab, grasp
2 ghrebh-	to dig, grub, grave, scratch
ghredh-	to stride, march
ghrēi- : ghrəi- : ghrī-, and lit. ghrei-	to smear over
ghreib-	to grip, grab
1 ghrem-	to rub, scratch
2 ghrem-	to grumble; resound, thunder
ghren-	to grind, rub, stroke hard
ghrendh-	beam
1 ghrēu- : ghrəu- : ghrū-	to collapse, fall down
2 ghrēu- : ghrəu- : ghrū-	to crush, rub sharply
ghroud-	(round body part, e.g. cheek, bosom)
gu̯ā-, gu̯em-	to come, go
gu̯ā̆dh-	to dive, sink, submerge
1 gu̯ēbh-, or gu̯ābh-?, gu̯əbh-	to plunge, dive in
2 gu̯ēb(h)-	slimy; frog
gu̯edh-	to hit, push; harm, injure
1 gu̯ei-	to cry, weep, complain
2 gu̯ei-	to enclose, push together
3 gu̯ei̯-, and gu̯ei̯ə-	to live, survive
gu̯ēi-, or gu̯ei̯ə- : gu̯ī-	hide, skin
gu̯eid(h)-	mud
gu̯ei̯ə-	to prevail, overpower, be mighty
1 gu̯el-	to stab; pain, death, quell
2 gu̯el-, gu̯elə-, gu̯lē-	to flow, drip down; throw
3 gu̯el-, gu̯el-, gu̯lā-	acorn, valonia; oak?
gu̯elbh-	womb, uterus; young animal
gu̯em-	to go, come
gu̯ē̆nā	wife, queen, woman
1 gu̯er-, gu̯erə-	to swallow; craw, gorge, throat
2 gu̯er-, gu̯erə-, gu̯erəu-, gu̯erī-	grave, heavy
3 gu̯er-, gu̯or-	mountain
4 gu̯er(ə)-	to praise, congratulate, raise one's voice
g̑u̯er-, g̑u̯erə-	to burn, be hot
gu̯eru-	pole, spit
gu̯es-, zgu̯es-	to quench, extinguish
gu̯es-, gȗos-, gus-, extended gu̯oz-do-	leaves, branches
1 gu̯et-	resin
2 gu̯et-	to speak, talk
gu̯et-	swelling
gu̯ii̯ā, gu̯ii̯ós	sinew
gu̯is-ti-s	finger
gu̯īu̯-	resin
gu̯l̥tur(os)	vulture
gu̯or-gu̯(or)o-	dirt, dung
gu̯ou-	cow, ox, gaur
gu̯ōu-, gu̯ū-	dirt, dung
gu̯ozd(h)o-, gu̯ozd(h)i-	nail, penis
gu̯rebh-	young, embryo
gu̯reig̑-	to sleep, dream
gu̯rendh-	to swell; breast
gu̯retso-	big, thick, gross
gu̯rēug̑h-, gu̯rū̆g̑h-	to bite, grind one's teeth
gu̯hðei(ə)-	to destroy, perish
gu̯hðer-	to flow, run
gu̯hedh-	to ask, beg, wish for
*gu̯hēi- : gu̯həi-, gu̯həi-d- : gu̯hīd-	bright, shining
gu̯heiə- : gu̯hī-	vein, sinew, tendon
gu̯hel-	to want, wish
g̑hu̯el-	to bend, swerve
g̑hu̯elg-	to glance, look at
gu̯hemb-	to hop, spring (happily)
g̑hu̯en-	to sound
1 gu̯hen-	to swell, abound
2 gu̯hen(-ə)-	to hit, strike, fend
g̑hu̯ē̆r-	wild animal
gu̯her-	warm, hot
g̑hu̯oigu̯-	to shine; star
g̑hu̯ōku̯-, g̑hu̯əku̯-	to shine, shimmer
gu̯hrē-	to scent, smell
gu̯hren-	diaphragm; mind, soul
hā̆	(surprise: ha! oh!)
ha ha!	(laughter)
īl-, īlu-	dirt, mud; black
īli-	groin, intestines
i̯ā- : i̯ō-	to punish, be angry, excited
i̯ā-	to go
i̯ag-	to worship, venerate
i̯agh-	to hunt, wish for
i̯āi	(demonstrative stem: one, this, etc.)
i̯ā̆m-, or i̯em- : i̯em- : i̯ōm-	to dig
i̯ām	(demonstrative stem: one, this, etc.)
i̯ē- : i̯ə-	to do, throw, project
i̯ebh-	to copulate
i̯eg-	ice, icicle
i̯ēgu̯ā	force, strength
i̯ek-	to speak
i̯ēk- : i̯ək-	to heal
i̯ē̆ku̯-r̥(t-), genitive i̯eku̯-n-és	liver
iēlo- : i̯əlo-	raw, unripe
i̯em-	to hold, match, defeat, geminate; twin
i̯énəter-, weak case i̯enətr-, i̯n̥̄tr-	sister-in-law
i̯ē-ro-	year, summer
i̯es-	to boil, foam up
i̯et-	to set out, strive for
1 i̯eu-	to mix, mingle (of meal preparation)
2 i̯eu-, i̯eu̯ə-, i̯eu-g-	to yoke, join, tie together
3 i̯eu-	young
4 i̯eu-	to separate, hold apart
i̯eu-dh-	to fight, move swiftly
i̯eug̑-	to excite, arouse; unsteady
i̯eu-ni-, or i̯ou-ni-	the right place/way
i̯eu̯o-	grain, esp. barley
i̯eu̯os-	rule, right, justice, statute
i̯o-	(relative stem: one, this, etc.)
i̯oi-ni-	reed (bulrush)
i̯ork-	(type of deer)
i̯ou, i̯u	(demonstrative stem: one, this, etc.)
i̯ō[u]s- : i̯ūs-	belt; to gird
1 i̯u-	you (plural)
2 i̯ū̆	yowl (exclamation of joy/wonder)
kā-	to like, wish, desire
kā̆, ke, kom	well! (particle)
kā̆d-	to rob, harm, damage; chase
kadh-	to guard, cover, protect
1 k̑ad-	to fall
2 k̑ad-	to shine, sparkle
k̑ād- : k̑ədes- : k̑əd-s-	hate, displeasure, uneasiness
kag̑o-, masc., kag̑ā- fem.	goat
kagh- : kogh-	to sew, plait, etc.
kaghlo-	chalk, pebble
1 kai-, kai-u̯o-, kai-u̯elo-	alone
2 kai	and
3 kā̆i-, kī̆-	heat
4 kāi-d-, kāi-t-	bright, shining
kai-ko-	one-eyed, cyclopean
kaik̑-, or koik̑-	to itch, scratch
kai-lo-, kai-lu-	bright; hale, whole, healthy
kais-	hair
kāi-t-	bright, shining
kaito-	chet, woods, forest
kaiu̯r̥-t, kaiu̯n̥-t	cleft, hollow, ravine
kakka-	to cack, defecate (nursery word)
kāk-	to croak; cracking sound
1 k̑ak-	to become thin
2 k̑ak-, k̑ek-?	to help, enable
1 k̑āk- : k̑ək-, probably k̑ā[i]k- : k̑īk-	to jump, spring out
2 k̑ā̆k-	branch
1 kal-	hard, callous; blister
2 kal-, kali-, kalu-	handsome, beautiful; healthy
3 kā̆l-, kō̆l-?	to be captured; prison
kalni-	narrow path/passage
kam-er-	to bend, curve
kā̆m-	to like, wish, desire
kamb-	to bend, curve
kam-p-	to bend
kan-	to sing, chant, sound
kand-, skand-, and Indo-Iranian (s)kend-	to glow, shine; bright, candent
k̑ank-	to jump, spring out
kan-tho-	curve, angle, corner
kap-	to cop, grab, grasp; have?
kāp-, kəp-	piece of land
kā̆po-	thing in the water
kapro-	he-goat
kap-ut	head
kā̆pho-, or k̑ō̆pho-	hoof
1 kar-	to scold, punish, revile
2 kar-, karə-	to glorify, praise aloud
3 kar-, reduplicated karkar-	hard
kār-	wax
kars-	to rub, scratch
k̑as-, k̑as-no-	gray
k̑ās-, k̑əs-	to teach, show the way
1 kat-	to link, plait, weave; chain, net
2 kat-	to bear young; young animal
k̑at-	to fight, struggle; battle
kau-	to humble, discourage
kāu-, kəu-	to hew, cut, hit
kā̆u-, kē̆u-, kū-	to howl
kā̆u(ə)lā : kūlā	boil, abscess, swelling
kau-l-, ku-l-	hole, hollow; bone
kaus-	to draw lots
k̑e-	this
ked-	to smoke
keg-, keng-, and kek-, kenk-	peg, handle, (grappling) hook
kēi-	to move, set in motion
1 k̑ei-	to lie, recline; camp, home
2 k̑ei-	(dark color: brown, gray)
k̑ē(i)- : k̑ō(i)- : k̑ə(i)-	to hone, whet, sharpen
k̑ēi-bh-	fast, hasty, violent
keid-	to fall
k̑ēi-gh-	fast, hasty, violent
k̑eip-	to slant, slope; to wag, wave
k̑eipo-, k̑oipo-	peg, stake, sharp wood/stone chip/piece
keis-	arm; thigh, shin
kek̑-	weasel
keku-	cudgel, hammer-shaped stick
k̑ēko-	green grass/fodder
k̑eku̯-	to defecate; dung, excrement
1 kel-, kelə-	to project, tower up; hill
2 kel-	to stab, stick, sting
3 kel-, kelə-, klā-, extended klād-	to hit, hew, cut down
4 kel-, and kāl-	light and dark spots
5 kel-	to drive, compel, accelerate, move quickly
6 kel-, k(e)lē-, k(e)lā-, or kl̥̄-?	to call, cry
7 kel-, kol-, kol-	calix, chalice, goblet, beaker
8 kel-	to cut
9 kel-	to owe, be guilty
10 kel-	to dry out
11 kel-	to bend; crooked
kēl-, kōl-, kəl-	to deceive, dumbfound, enthrall
1 k̑el-	cold; warm, caloric
2 k̑el-	to bow, lean, incline
3 k̑el-	thin shaft, stalk
4 k̑el-	to hide, conceal
k̑elb-, k̑elp-	to help
keleu-	to wander; way, path
keləu̯o-, keleu̯o-	bald, bare
kelg-	to wind around; windings, intrigue
kelp-, kl̥p-	jug, pot, cauldron
1 kem-	to squeeze, hem in, press together
2 kem-	to hum, buzz, croon
1 k̑em-, or k̑am-	horn, pole, stick
2 k̑em-	hornless (normally horned) animal
3 k̑em-	to wrap, cover, conceal
4 k̑em(ə)-	to be/make tired
kemə-, komə-, kmā-	bite, piece
kemero-, komero-, kemero-	(plant name)
kemer-	armored animal (crab, turtle, etc.)
1 ken-	to pinch, press, etc.
2 ken-, kenə-, keni-, kenu-	to rub, scrape, scratch off; ashes
3 ken-	to begin, be born, come forth anew; young, recent
4 ken-	to strain, strive eagerly
k̑en-	void, empty
kenəkó-	golden, honey-colored
keng-, kenk-	peg, handle, (grappling) hook
1 kenk-	to bind, gird
2 kenk-	to burn, hurt; dry feeling: thirst, hunger
3 kenk-	heel, hock, back of knee
k̑enk-, k̑onk-	to hang, sway, dangle
k̑ens-	to announce, proclaim, speak formally
kenth(o)-	rag, cloth
k̑ent-	to stab, stick
1 ker-, kor-, kr-	(onomatopoeic: hoarse sound)
2 ker-	to cut
3 ker(ə)-	to burn
4 ker-	cherry
5 ker-?, kō̆r-	to hang
6 ker-, and k̑er-	dirty, dark-colored, etc.
7 ker-	to jump, turn
1 k̑er-, k̑erə- : k̑rā-, k̑erei-, k̑ereu-	horn, head, upper part of body
2 k̑er-, k̑erə-, k̑rē-	to grow, increase
3 k̑er-	rope, string; to plait, weave
4 k̑er-, and k̑erə- : k̑rē-	to harm, injure; ruined, spoiled
k̑erbero-, and kerbero-	checkered, variegated
1 kerd-	to gird
2 kerd-	craft, talent; skilled
k̑erdho-, k̑erdhā	line, row, herd
k̑ered- : k̑erd-, k̑ērd-, k̑r̥d-, k̑red-	heart
kerem-, krem- : krom-, and kerm-	onion or garlic; ash (tree)
kerəp-, krēp-	cloth, leather rag; shoe
kerk̑- : kork̑- : kr̥k̑-	to wrinkle, shrivel up
k̑erə-, k̑rā-	to cook
kerm-	to rest, tire
kerno-	jaw, chin(bone)
k̑ē-ro-	colorful (or a color term)
kers-	black, dirty; dark color
1 k̑er(s)-	bristle, stiff hair
2 k̑ers-	to run, course
kert-, kerət-, krāt-	to roll, turn, wind
kes-	to comb, itch, scratch
k̑es-	to cut
kē̆t-, kot-	room, dwelling place
1 keu-, skeu-, lengthened grade kēu-	to see, hear, observe, hearken, attend to
2 keu-, keu̯ə-	to bend
1 k̑eu-, k̑eu̯ə- : k̑ū-, k̑u̯ā-	to swell
2 k̑eu-	to shine, be bright
1 k̑ēu- : k̑ū-	to sway, totter
2 k̑ēu- : k̑əu-, k̑ū-	to burn, light (a fire)
k̑eub-	thorn
keuəd-, kū̆d-	to cry, shout
keu̯əp- : ku̯ēp-, ku̯əp-, kū̆p-, and occasionally keu̯(e)p-, k(e)u̯ep-	to boil, cook, smoke
k̑ēu̯ero-, k̑ōu̯ero-, also sk̑ūro-?	north (wind)
k̑euk-	to glow, shine, be bright white
k̑euk̑-, k̑uk̑-	to whirl, mix together
kik-	jay (bird)
1 k̑ik-	belt, strap, thong
2 k̑ī̆k-	to rain, drizzle
k̑ik̑er-	pea
k̑īō̆n-, k̑īsō̆n-?	pillar
k̑iph-	thin flexible twig/root
kistā	basket, plaited container
klā-	to lade, place, heap up, lay down
klādhrā	alder (tree)
klau-	to weep
klēg-, klōg-, kləg-, klang-, kleg-, klōg-, kleig-, kleik-	to cry, shout, scream
k̑lei-	to lean, incline, tip (over)
kleik̑-	to press/squeeze (painfully)
klem-, klēm-, klem-	weak, slack, feeble, ailing
kleng-, and klenk-	to bend, wind
kleno-	maple (tree)
klep-	wet, damp
k̑lep-, sk̑lep-?	to steal, cover, secrete
klēp-	to hold in arms and/or lap
klēu-, also klĕu-?, and klāu-	hook, crook
1 k̑leu-, k̑leu̯ə- : k̑lū-	to hear, listen
2 k̑leu- : *k̑lō[u]- : k̑lū-	to clean, rinse, swill
k̑lou-ni-	hip, buttock
knei-gu̯h-, knei-b-	to bow, kneel
kneug-	(onomatopoeic: to growl, whimper)
knid-, k̑nid-, sknid-	nit, louse
k̑o-, k̑e-, with the particle k̑e, k̑(e)i-, k̑(i)i̯o-	this; here
kob-	to fit, fare well, be happy/successful
koi-, ku̯ī-	(creaking noise)
koi-lo-	naked; miserable
k̑oi-no-	grass
kois-	to cure, worry, care for
ko ko, kak(k)-, ku(r)kur-	(onomatopoeic: sound of cock/hen)
kok̑sā	body part: foot, coxa, etc.
kolə- : klō-	to spin
k̑oləmo-s, k̑oləmā	reed, stalk, stem, culm
kol(ē̆)i̯-	glue
koli-	young dog/animal
kom	at, by, cum, with, alongside
konəmo-, knāmo-, or kenəmo-	shinbone
k̑onk-	to doubt, vacillate
k̑onkho-	conch, clam(shell), mussel
k̑op(h)elo-s, or k̑ap(h)elo-s	(type of carp)
kopso-	blackbird
k̑orkā	grit, gravel
k̑ormen-	weasel
k̑ormno-, k̑r̥mno-	corrosive liquid: lye, wine, urine, etc.
k̑ormo-	harm, pain, torment, suffering
koro-s, kori̯o-s	war, army, warrior
kos(e)lo-	hazel (tree)
kost-	leg, bone, costa
k̑rā̆po-, k̑rō̆po-?	roof
k̑rā-	to cook, mix
krāt-	to roll, turn, wind
krā[u]- : krəu- : krū̆-	to heap up, pile together; heap; roof
k̑re-, k̑rei-, k̑r̥̄-	(hoarse sound)
k̑rē-	to harm, injure; ruined, spoiled
kreb-	(hoarse sound)
k̑rebh-, k̑rō̆bh-, k̑rembh-	to entrust
kred-	beams
k̑red-	heart
1 kreg-, and kerg-?	to torment
2 kreg-	(hoarse sound)
1 krei-	to brush, stroke, touch
2 krei-, kreig-, kreik-	(hoarse sound)
k̑rei-	to appear, show forth
1 krek-	to hit
2 krek-, kr̥k-	roe, fish/frog spawn
3 krek-	(hoarse sound)
4 krē̆k- : krok-	to tower, jut out; beams
krem-	onion or garlic; ash (tree)
1 krep-, kr̥p-	form; corpse, body
2 krep-	(hoarse sound)
1 krēp-	firm, strong
2 krēp-	cloth, leather; shoe
1 kret-	to shake
2 kret-	to hit
1 kreu-, kreuə- : krū-, kreus-, krus-	raw flesh, thick/clotting blood; ice, crust
2 kreu-	to crash, collapse, fall down
3 kreu-, krou-s-	to push, hit, break
4 kreu-	(hoarse sound)
kreup-	scab
kreu-t-, kreu-dh-?	to shake, move visibly
krom-	lattice, framework, wooden fence, etc.
kr(o)k-sko-	arm
k̑rūs-	leg, shank, thigh
krū̆t-	breast, belly; vault, protuberance
k̑sā-	to burn
kseip-, kseib-	to toss, throw
ks-en-, ks-es-, ks-eu-	to comb, itch, scratch
k̑sē̆-ro-	dry, xeric, bright (of weather)
kseubh-	to sway, swing, totter
kseud-	to grind, stamp to little pieces
k̑þei-	to settle
kþē(i)-, kþə(i)-	to gain, acquire, possess
ku-, kus-	to kiss
k̑ū-	sharp, pointed; pike, stake
k̑ū̆dh-	dirt, dung
kuku	(onomatopoeic: to coo, cuckoo)
k̑up-	shoulder
ku̯ak-	(onomatopoeic: to quack, croak)
ku̯at(h)-	to ferment, become sour
1 k̑u̯ei-, k̑u̯ei-no-	dirt, mud; to defile
2 k̑u̯ei-	to hiss, twitter, whistle, etc.
3 k̑uei-, extended kuei-d-, kuei-s-, kuei-t-	to shine; white
k̑u̯ek-, nasalized k̑u̯enk- : k̑uk-	to gape
k̑u̯el-	muddy
ku̯elək-, or kelək-, kolək-	bale, bundle
1 ku̯elp-, ku̯elb- : ku̯l̥p/b- : klup/b-	to stumble, buckle at the knees; to trot
2 ku̯elp-	to curve, vault
k̑u̯en-	to celebrate; saint
k̑u̯endh-ro-, -no-	(type of plant)
ku̯erp-, also ku̯erb-	to turn, wind
k̑u̯es-, k̑us-	to pant, puff, sigh, wheeze
ku̯ēt-, ku̯ət- : kū̆t-	to shake, winnow
ku̯oi-, ku̯ī-	to want, wish for
k̑u̯on-, k̑un-	hound, dog
ku̯res-, ku̯ers-, ku̯r̥s-	small wood, trees
kha kha	(laughter)
ku̯alo-s	(big fish)
ku̯as-i̯o-, -lo-	basket, plaited work
1 ku̯e	(enclitic) and
2 ku̯e-	(indefinite/interrogative pronoun)
ku̯ē̆d-, ku̯ō̆d-	to bore, drill, prick, stab
1 ku̯ei(-t)-	to observe with respect, pay attention to
2 ku̯ei-	to stow, gather, pile up
ku̯ei̯ə-, ku̯ii̯ē-	to rest comfortably; quiet, peaceful, tranquil
ku̯ek̑-, ku̯ōk̑-, ku̯ek̑-s-	to see, show, appear
1 ku̯el-, ku̯elə-	to turn; wheel; neck?
2 ku̯el-	far away
3 ku̯el-	crowd, herd, swarm
ku̯em-	to gulp, sip, swallow
ku̯ene	(particle: uncertainty, generalization)
ku̯enth-	to suffer, endure
1 ku̯er-	to do, make, form
2 ku̯er-	dish, pot
ku̯eru-	to chew, grind
ku̯etu̯er-, ku̯etu̯ō̆r-, ku̯etur- (masc.), ku̯etes(o)r- (fem.)	four, fourth
ku̯o-, ku̯e-, fem. ku̯ā, ku̯ei-	(indefinite/interrogative pronoun)
ku̯rei-	to buy
ku̯r̥mi-	grub, worm, maggot
ku̯sep-	dark
ku̯þei-	to destroy, perish
ku̯ās- : ku̯əs-	to cough
1 lā-, and lē-	(onomatopoeic: to bark, howl, etc.)
2 lā-	to be hidden, covered, latent
lab-, and labh-, lap(h)-	to lap, lick, smack (the lips), etc.
labh-	to grab, hold, seize
lā̆gh-	to cut; cutting tool
lāgu̯h-	to grab, seize
lai-	fat, lard
laidh-, lidh-	to cut, hurt, injure
laiu̯o-	(on the) left
lā[i]p-, ləip-, ləp-	to burn, shine
lak-	to lap, lick
lak̑-	to spot, sprinkle
laku-	(water in) lake, pond, ditch, etc.
lāmā	swamp, puddle
lāp-	cow
las-	greedy, covetous
lat-	wet, damp; swamp
lāu-	to acquire (as booty), enjoy something
lauk(o)-, ləuk-	jaw; throat
lē-	(onomatopoeic: to bark, howl, etc.)
lē̆b-, lō̆b-, lāb-, leb-	lip; to slump, hang down slackly
1 leg-	to leak, drip, dribble, ooze out
2 leg-	to worry
leg̑-	to gather, collect
legh-	to lie, recline, set down
1 lēg̑(h)- : ləg̑(h)-	branch, twig
2 lēg̑h- : ləg̑h-	to crawl; low
legu̯h-	to move easily
1 lē̆i-, lek-	to flex, bend
2 lei-	to dissipate, disappear; thin, weak
3 lei-	slimy; to slip, glide
4 lē̆i-	to pour
1 lē[i]- : ləi-	to want, wish
2 lē(i)-	to grant/acquire possession
3 lē(i)-	to weaken, leave behind; feeble
leibh-	to smear, stick
leid-	to play, joke
1 leig-, and leik-, better oleig-, oleik-	needy, miserable
2 lē̆ig-, līg-	form, appearance; like, similar
3 leig-, loig-	to hop, jump, tremble
4 leig-, leig̑-	to tie, bind, ligate
leig̑h-, sleig̑h-	to lick
1 leik-	to offer for sale
2 leik-	to bend
leiku̯-	to leave, relinquish
1 leip-	to smear (with fat), stick
2 leip-	to desire, request, wish for
leis-	to furrow; learn
1 leit-	to loathe, detest, abhor; violate
2 leit(h)-	to die, go away
leizd-, loizd-	edge, fringe, hem
1 lek-? : lok-	to blame, scold, reprove
2 lek- : lek-, and lēk- : lək-	joint, leg, body member; to bend, wind
1 lēk- : lək-	tendril; trap
2 lēk- : lək-	to lacerate, tear to pieces
1 lem-	to break, crush to pieces; lame, fragile
2 lem-	astonishment (with the notion of wide open jaws)
1 lendh-	spring (of water), wetness
2 lendh-	hip, loins; kidney
3 lendh-	heath, steppe, open land
leng-	to sway, bend oneself
lengh-	to scold, scorn
lenk-	to bend
lento-	lithe, flexible, pliable
1 lep-	(onomatopoeic root)
2 lep-	to flay, peel, skin
3 lep-	rock, stone
lēp-, lōp-, ləp-	flat
lerd-	to twist, shrivel up
lerg-	even, smooth, slippery
les-	to lease, collect, pick up
lēs : ləs-	weak, slack, feeble
leto-, lēti-, lēto-, lōto-	heat, burning, anger
lēto-, ləto-	daytime; summer, warm season
letro-	leather
1 leu-, *leu̯ə- : lū̆-	dirt
2 leu-	to free, cut off, separate
1 lēu-	to leave behind
2 lēu- : ləu-	stone
3 lēu-, or lāu-	(onomatopoeic: to bark, howl, etc.)
leubh-	to love, like, care for
leud-	to lout, bend over, duck down; bent, little, etc.
1 leudh-	to grow up; free; people
2 leu-dh-	to go, move, drive
1 leug-	to bend
2 leu-g- : lu-g- : lū-g-	blackish; swamp
leug̑-	to break
1 leugh-	to lie, belie, prevaricate
2 leugh-, lugh-	oath
leuk-	to light, shine; see
leup-, and leub-, leubh-	to lift, peel, cut/break off, etc.
lēut- : lūt-	angry, raging, wrathful
lī̆-no-	flax, linen
log̑-	rod, twig
lorgā-, lorgi-	stick, club
lou-, lou̯ə-	to lave, wash
lū̆s, genitive luu̯-ós	louse
1 mā-	to beckon, wave (hand); deceive
2 mā-	timely, opportune
3 mā	ma, mama (nursery words)
mad-	to drip; wet; fat, glossy, well-fed
magh- : māgh-	to help, be able; might, power
maghos	maiden, young person
mag̑-	to knead, press, stroke
mag̑h-	to fight, struggle
1 mai-	to maim, hew, cut with sharp instrument
2 mai-, moi-?	to smudge, stain
mak-	skin, leather bag
1 mā̆k-	wet, damp; to soak
2 māk-	to knead, press
mā̆k(en)-	poppy
mak̑o-, or mok̑-o-	fly, gnat
māk̑- : mək̑-	long and slender
makh-o-s	bold, wild, frisky, unbridled
mand-	pen/hurdle of plaited rods/twigs
mā-no-, mā-ni-	wet, damp
manu-s, or monu-s	man, human being
marko-	mare, horse
1 math-, or moth-	moth, harmful insect
2 mat-	club, hoe, mattock
mātér-	mother
mau-ro-	tired, weak; dark
mazdo-s	mast, pole
1 me-	me (1st pers. sg. oblique pronoun stem)
2 me-	by, with, amidst, around
1 mē-	(prohibitive particle: lest, that not)
2 mē-, m-e-t-	to mow, reap
3 mē-, m-e-t-	to measure
4 mē-, mō-	big, important
5 mē-, mō-, mə-	to be intent; of strong will
1 med-	to mete, allot; medicate, give advice
2 med-	to swell
medhi-, medhi̯o-	middle
médhu	mead, honey
mē̆gh-	friendly, well-disposed
meg̑(h)- : meg̑(h)-	big, much, great, major, mega-
1 mei-	to mure, repair, strengthen; pole
2 mei-	to change, mutate, exchange
3 mei-	to go, wander
4 mei-	to tie, bind
5 mei-, mi-neu-	to lessen, diminish; small, minor
6 mei-, mei̯u-, min(u)-, mim(ei)-	(onomatopoeic: high thin sound)
7 mēi- : mōi- : mī-	mild, soft
meigh-, also meik-	to flicker, twinkle; mist
meig̑h-	to micturate, urinate
mei-gu̯-	to (ex)change
mei-k̑-, and mei-g̑-?	to mix, mash, stir
mei-no-	view, opinion, intention
meis-	to flicker, twinkle; mist
1 meit(h)-	place to stay
2 mei-t(h)-	to commute, (ex)change
mek-	(onomatopoeic: to bleat)
1 mel-, also smel-, melə- : mlē-, mel-d- : ml-ed-, mel-dh-, ml-ēi- : mlī̆-, melə-k- : mlā-k-, mlēu- : mlū̆-	to mill, grind; fine, ground
2 mel-	to deceive
3 mel-	to hesitate
4 mel-	big, strong
5 mel-	limb; to join
6 mel-, melə-	dark color (black, dirty, etc.)
7 mel-	wool, woolen garment
8 mel-, melə- : mlō-	to appear, come forth
1 meldh-	to utter ritual words (to deity)
2 meldh-	lightning
mē̆lg̑-, or meləg̑-?	to milk, pluck, wipe off
melg̑h-	to swell
meli-t, genitive mel-nés	honey
1 melk-	to rub, stroke
2 melk-, melg-	wet
mēlo-, smēlo-	small animal
melōdh-, molədh-, molədh-	head; elevation
mels-	to taste
membh-	to reproach
mēmso-, mē(m)s-ro-	meat, flesh
1 men-	to rise, mount, tower
2 men-	to press, step on, tread down
3 men-	to think; mind, spiritual activity
4 men-	to diminish; small
5 men-	to stay, remain, stand still
mend-, mond-, mn̥d-?	to feed, suck(le); breast
mendā	flaw, defect, mistake
mendh-	to direct attention to; vivacious
men(e)gh-, mon(e)gh-, mn̥gh-	many, copious, abundant, excessive
men(ə)k-	to knead
meng-	to make pretty, beautiful
meni-	minnow (or other type of fish)
mēnōt, genitive mēneses, from which mēnes-, mēns-, mēs-, mēn-	month; moon
1 menth-, meth-	to stir, swirl, mix up
2 menth-	to chew, eat
1 mer-	to plait, weave; rope
2 mer-	to flicker, shimmer
3 mer-, mor-(u-)	to blacken; dark color, dirt spot
4 mer-, merə-	to die
5 mer-, merə-	to rub, wipe; pack, rob
6 mer-, mer-s-	to anger, bother, disturb, etc.
merədh-, mrādh-	to boil, bubble up
mereg̑-	march, edge, border, frontier
meregh-	to soak, moisten, drizzle
1 merg̑-	to wipe off
2 merg̑-	to grab, seize
meri̯o-	young man/woman
merk̑-	to grab, seize
1 merk-, merg̑-, merək-, merəg̑-	to rot
2 merk-, mork-	vexed, sullen
mə-r, genitive mə-n-és, mn̥tós	hand
met-	to reap, measure
1 meu-, meu̯ə- : mū̆-	wet, damp; to wash; dirt, mud, mire
2 meu̯-, meu̯ə-	to move, push away
mēudh-, məudh-, mūdh-	to complain, care about, be intent
1 meug-	to lie in wait, take by surprise; wily
2 meug-, meuk-	to slip, slide; meek
meuk̑-	to tear, slit, scratch
meu-s-	to steal
1 mezg-	to dive, plunge, immerse
2 mezg-	to bind, knit, knot, attach
mizdhó-	fee, pay, meed, reward
mō-, mo-lo-	to strain, trouble oneself
mōd- : məd-, or mād- : məd-	to meet, approach
modhro-, or madhro-	blue; madder
moiso-s, or maiso-s	sheep; hide, pelt, leatherwork
mok̑s, Indo-Iranian *mok̑sū̆	soon
molko-	pouch, leather bag
mono-	neck; mane
mori, mōri	mere, sea
mormor-, murmur-	to murmur (dully)
mormo(ro)-	fear, dread, horror
moro-	murrey, mulberry, blackberry
moru̯ī̆-	maur, mire, ant
mo[u]-lo- : mū-lo-	root, plant
mō[u]-ro- : mū-ro-	crazy, stupid
moz-g-o-, moz-g-en-, mos-k-o-	brain
mozg̑ho-s	young cattle
mrk-	more, carrot, edible root
mregh-m(n)o-	brain, skull
mreg̑hu-, mr̥g̑hu-	brief, short
1 mū̆-	(onomatopoeic: to moo, hum, etc.)
2 mū-, mus-	fly, gnat, midge, muscid, mosquito
mū̆k-	heap, etc.
mūs	mouse; muscle
mut-o-s	trimmed, stunted, circumcised, mutilated
1 nā-	to help, be useful
2 nā-	to be afraid, ashamed
nāgu̯h-	sober?
nak-	fur, pelt
nana, nena	nana (nursery word: (grand)mother, etc.)
nant-	to dare, risk
nas-	nose
1 nāus-	boat, ship
2 nāu- : nəu- : nū-	death; corpse
1 nĕ, nē, nei	(negative particle: no, etc.)
2 ne, nē	that (enclitic particle)
3 ne-, nō-, plural nē̆s-, nō̆s-	we
1 nebh-	to burst
2 nebh-	wet, damp; clouds; water
1 ned- : ned-	to net, bind, connect, roll up, twist together
2 ned-	to roar, sound, bellow
nedo-	reed
neg̑h-	to bore, pierce, stab, stick
1 nei-, neiə- : nī-	to lead
2 nei-, neiə-, nī-	to be moved, excited; to shine
3 nei-, ni-	in
1 neid-	to scold, shame, abuse
2 neid- : nid-	to flow; stream
neigu̯-	to wash
neik-	to winnow (grain)
nēik- : nīk- : nik-	to rail, fight, assault
nek̑-	death, dying, necrosis; corpse
neku̯-(t-), noku̯-t-s	night
1 nem-	to nim, take, give, count, apportion
2 nem-	to bend
nepōt-	nephew; grandchild
1 ner(-t)-, aner-, əner-?	vital force; man
2 ner-	below, under
3 ner-	to penetrate; hiding place, hollow
nes-	to unite; be concealed
ni-, nei-	in
nē-tr-, nə-tr-	snake, adder
1 neu-	to call, praise
2 neu-	to push (someone); to nod
neu-d-	to grasp, make use of
neu-dh-	to lust, desire, yearn for
neuk-	dark, unclear, indistinct
neu-ks-, neu-s-	to scent, smell, sniff
neu̯os, neu̯i̯os	new
niz-do-	nest
no-	that
nogu̯-, nogu̯od(h)o-, nogu̯-no-	nude, naked
nogu̯o-, or nagu̯o-	tree
noku̯-(t-)	night
nōmn̥	name
nōt-, nət-	rump, nates, backside
nū̆-	now
n̥dhos, n̥dheri	under
n̥si-	black, dirty
n̥si-s	sword
1 o	to, with
2 ō	O (vocative particle)
obhel-	to sweep; multiply
obhi-	to, from, around, etc.
1 od-	to smell
2 od-	hatred, disgust, odium, aversion
ō̆d(e)go-, or ō̆d(e)gu̯o-	stem, stalk
ōg-, əg-	to grow; fruit, berry
oi-	(pronoun stem)
oid-	to swell; strong
oi-no-, oi-u̯o-	(demonstrative particle: one, this, etc.)
oiu̯ā	(vocative particle)
ok-	to consider
ok̑tō(u)	eight, octad
ōk̑ú-s	quick(ly)
oku̯-	to see, ogle; eye
ol-(e-)	to destroy
om-	raw, coarse, bitter
om(e)so-s	shoulder
omə-	to suffer; firm up, proceed energetically
ond-, n̥d-	rock, stone
oner-	dream
ong-, better ang-	coal
ongu̯-	to anoint
ono-, and onə-, also (o)no-d-	to scold, abuse, revile
onogh- : ongh-, nogh-, Celtic n̥gh-, ongh-li-	claw, (finger/toe) nail
1 op-	to work, perform, operate, bring about
2 op-	to opt, choose, opine, suggest
opi	at, by
ōr-, ər-	to call, speak, talk, orate
orbho-	weak, abandoned; slave, orphan
oreu̯-, ereu-	entrails
org̑hi-, r̥g̑hi-	testicle
org-	to hit, kill
ort-	vine
*ōs, ōs-i-s, ō̆s-en-, os-k-	ash (tree)
ost(h)-, ost(h)i, ost(h)r̥(g), oblique ost(h)-(e)n-	os, bone
oug-, ou-?	cold
ō(u̯)i̯-om	egg, ovum
óu̯i-s	ewe, sheep
1 ōus- : əus-	os, mouth
2 ōus- : əus- : us-	ear
ozdo-s	branch
ozgho-	bud, sprout, twig
pā- : pə-, and pā-t- : pə-t-	to feed, graze, pasture
pā̆k̑-, and pā̆g̑-	to repair, strengthen
pā̆n-	pane, panel, woven fabric
pando-s	crooked
pank-, pang-	to swell
pap(p)a	papa (nursery word); food, meal
pā̆r-	to show, be visible
parīkā	concubine
pāsó-s	a relative
pasto-	firm, fast, solid
paus-	to free, let loose
pāuson-, pūson-	(name of a deity)
1 pē̆d-, pō̆d-	to hold; vat, vessel, container
2 pē̆d-, pō̆d-	foot
peg- : pog- : pōg-, pō̆k-s-	hip, side, shoulder
pē(i)-, pī-	to hurt, scold, shame
pei̯(ə)-, pī̆-	fat; milk
1 peig-, and peik-	colored, speckled
2 peig̑-, and peik̑-	to be hostile
pei-m(i)-	swift, quick, rapid, nimble
1 peis-? : pis-	to grind, trample
2 peis-, speis-	to blow, fizz
peisk-, pisk-	fish
1 pek̑-, pēk̑-, pōk̑-	to be joyful, make pretty
2 pek̑-	to fleece; fee, cattle
peku̯-	to cook
1 pel-, pelə-, plē-	to pour, fill; full, plenary; town?
2a pel-, pelə- : plā-	to drive, propel, set in motion
2b pel-, pel-en-, pel-t-, pel-u̯-	dust, powder; meal, flour
3a pel-	to fold
3b pel-, pelə-, plē-	to wrap, cover; cloth; fell, pelt
4 pel-	dish, vessel
5 pel-	to earn, sell
6 pel-	gray, dull color; pallor
7 pel-, pol-, plē-, plō̆-	to burn, be warm
pelə-, plā-	plane, flat, wide, broad
peli-s-, pel-s-	fell, rock
pelk̑- : polk̑-	to turn, bend
pelpo-, or polpo-	woodwork
1 pen-	to feed
2 pen-, pen-ko-	mud, fen, swamp, water; wet
penku̯e	five, fifth
pent-	to go, walk, pad, tread; way, path
1 per-, perə- : prē-, preu-	to spray, sprinkle, drizzle
2a per-	to pass over/beyond
2b per-, perə-	to fare, ferry, transport, go/carry over
2c per-, perə-	to sell, impart
2d per-	to bear (a child)
2e per-	to dare, risk, try; peril, danger
3 per-, per-g-	to hit, kill
perd-	to fart, break wind (loudly)
1 perg-	pole, stem, trunk
2 perg-	fear; to frighten
1 perk-, prek-	to fill up
2 perk- : pr̥k-	coals, glowing ash
1 perk̑-	breast, rib cage
2 perk̑-, prek̑-	spotted, speckled
3 perk̑-, pr̥k̑-	to open, dig out, rip up; furrow
4 perk̑-, prek̑-, pr̥k̑-	to request, ask/pray for
perku̯u-s	oak
pers-	to spray, sprinkle, drizzle; dust, ashes
persnā, persnī̆-, persno-	heel
perth-	pole, stick
1 pē̆s-	to blow
2 pēs-, nasalized pēns-	dust, sand
3 pes-, pesos	penis
1 pet-, pet-, petə-	to stretch out (esp. arms)
2 pet-, petə- : ptē-, ptō-, Hellenic ptā-	to fall, tumble down
1 peu-, peu̯ə- : pū̆-	to sift, clean, purge, purify
2 peu-	to repute, explore, understand
3 peu-	foam, froth
pēu- : pəu- : pū̆-	to hit; sharp
peuk̑-, and peug̑-	to pink, stab, stick
peu̯ə-	to rot, stink
peu̯ōr, pū̆r, genitive pu-n-és, locative puu̯éni	fire
pezd-	to break wind (softly)
pətḗ(r), genitive pətr-és	father
pid-	to bear, give birth?
pik(h)o-	knot, lump
pi-lo-	hair, pile, pilus
pi-n-	piece of wood
pī̆p(p)-	to peep, squeak
pīzdā-	vulva
plab-	to babble, prattle, etc.
1 plā-k- : plə-k-, ple-k- : plō̆-k-, plei-k-, and pelə-g- : plā-g- : plə-g-	flat, wide, broad; spread out
2 plāk-, plāg-, also plēk-, plēg-	to hit, beat, fling
plā̆t-, plā̆d-, plē̆t-, plō̆t-, plət-	flat, wide, broad; spread out
plē-, plə-	to cut, split off
plēi-, pləi-, plī-	bald, bare, naked
plek̑-	to ply, pleach, plait, weave
plēk̑-, plək̑-, and plēik̑-, plīk̑-	to flay, peel, rip, tear off
pleu-	to flee, fly, run; flow, swim
pleuk-	floc, hair, feather
pl(e)u-mon-, pleu-ti̯o-	lung
pleus-	to pluck, deplume, pull out; plucked hair/feathers
pləi-, pləu-	to broaden, show off
plouto-, pluto-	(wooden object)
pneu-	to pant, breathe
pn̥ksti-	fist
1 pō(i)- : pəi-? : pī-	to graze, pasture
2 pō(i)- : pī-, and (from pō-), po-	to bib, drink
polo- : pōlo-	big, fat, thick, swollen
pork̑o-s	porker, pig(let)
pos	about, around; by, beside; in front of
po-ti	against, opposite, toward
poti-s	host, husband, lord, master, owner
pōu- : pəu- : pū̆-	few, small, little; young (of animals)
pougo-, or pougho-	pure, clear
prā-	to bend
prāi-, prəi-, prī-, pri-	to like, feel friendly/well-disposed
preg-	greedy, covetous; willful, violent
prep-	to catch sight of
pret-, prō̆t-	to understand
preu-	to hop, jump
preus-	to burn, freeze
prīs-	to granulate, reduce to small pieces
prō̆-	to pass over/beyond
prōk̑to- : prək̑to-	rump, backside
pr̥so-	leek, onion, garlic
pster-, pstereu-	to sneeze
ptel(e)i̯ā	(type of tree, e.g. poplar/popple)
1 pū̆-, peu-, pou-, also phu-	to blow (up)
2 pū̆- : peu̯ə-	to rot, stink
3 pū̆-	to hit; sharp
1 pū̆k-, peuk-	thick-haired
2 puk̑-	to enclose, press together
pu-lo-	(stiff) hair
pū-ro-	grain, kernel
phel-	to cut, split, tear off; board
pher-	to rush, act rashly, push away, etc.
phō̆l-	to fall
phu-	to blow (up)
rabh-, or rebh- : rebh-	to rage, be furious
rāp-, rēp-	rape (plant), turnip
rā̆s-	to cry, (re)sound
1 rē-, rə-, extended rē-dh-	to count, compute
2 rē̆-, extended rē-dh-	separate
3 rē-	to row; oar
4 rē-	to rest, be still
5 rē-	dark
6 rē-	to cry
1 rebh-	to move, hurry about
2 rebh-	to roof, thatch
red-, rod-	to flow
1 rēd-	to excite, cheer up, be joyful
2 rēd- : rōd- : rəd-	to gnaw, scrape, scratch
1 reg-, and sreg-?	to dye
2 reg-	to see
1 reg̑-	to regulate, make just/right; king, reign
2 reg̑-, rek̑-, rek-?	damp; rain
regu̯os-	darkness
1 rei-	to cut, reap, rive, tear, scratch
2 rei-, roi-	spotted, speckled, brightly variegated
3 rei-, rē(i)-	to cry, scream, bellow, etc.
4 rei- : rēi-	thing, possession
5 rei-	to support
1 rēi- : rī-	to count, arrange
2 rēi-, rōi-	nut
reibh-	(onomatopoeic: to resound?)
reid-	to support, lean against
reidh-	to ride, go (in vehicle)
reig-, or reig̑-	to rig, tie, bind
reig̑-, rēig̑-	to reach, stretch out
rei̯ə-, rī-	to flow, move
reik-	to stretch oneself; pole
rei-r(ēi)-	(onomatopoeic: to quake, tremble)
rēito-, rēiti-	joint, shoulder (of animals)
1 rek-	to project, tower up; pole
2 rē̆k-	to reck, reckon, arrange, prepare
rek̑-, reg̑-	to bind
rek̑þh-	to harm, injure
rem-, remə-	to rest; to support
remb-, romb-, romb-	to hack, hoe
rendh-	to rend, rip, tear to pieces
rent-	thing?
rep-	to grab, rip out, ravish
1 rēp-, rep-?	to creep, crawl
2 rēp-, rəp-	pole, stake, beam, rafter
rēs-, rōs-	to flow
ret(h)-	to run, roll, rotate
rēt-, rōt-, rət-	pole, rood; stem, stick, trunk
1 reu-, rēu-, rū̆-	(onomatopoeic: to roar, rout, round, etc.)
2 reu-, reu̯ə- : rū̆-	to open, tear out, dig/rip up, etc.
3 reu-, reu-s-	to hasten
4 reu-	to search
reu-b-, and reu-g-	to belch, eruct, retch, vomit
reudh-	red
reugh-m(e)n-	ream, cream?
reus-	elm (tree)
reu-smen-	to chew, ruminate; throat, rumen
reuto-, routo-, rut-	stomach, intestines (of an animal)
reu̯ə- : rū-	to ream, open; wide, roomy
rezg-	to plait, weave, wind
roi-no-	hill, road
rughi̯o-	rye
ruk(k)-, rouk(k)-	yarn; fabric
r̥ksā	fetlock; tether
ŕ̥k̑þo-s	bear (animal)
sā-, sə-	enough, satiate, sufficient
sāg-	to seek, track, trail
sāi-	pain, illness; sore
saip-	fence, stall, enclosure
sak-	to sacrifice, sanctify, make a treaty
1 sal-	sal, salt; brackish water
2 sal-	gray, dirty, sallow
sā̆lo-	wavy
sāno-s	sane, healthy?
sap-, sab-	to taste, savvy, perceive
sasi̯o-	(type of grain)
sā-ti-	satiated
saus-, sus-	sere, dry
sā́u̯el-, sāu̯ol-, suu̯él-, su̯el-, sūl-	Sol, sun
se-	self, one's own
sed-	to sit, set, settle
1 seg-	to sow (seed)
2 seg-, nasalized seng-	to attach, tack on
seg̑h-, seg̑hi-, seg̑hu-	to possess, hold fast, persevere, overcome; victory
sei-, soi-	to drip, be damp
1 sē(i)-	to sift
2 sē(i)- : səi- : sī-, sē- : sə-, and sei- : si-	to sow, dispatch, disseminate, let fall
3 sē(i)-, səi- : sī-, and sei- : si-	to bind, strap, tie
sē[i]dh- : sī̆dh-, and sədh-	to aim at, strive for
sē̆ik-, sī̆k-	to grip, reach for
seiku̯-	to spill, pour out
seip-, seib-	to sift, pour out
1 sek-	to run off, dry out (re: water)
2 sē̆k-	to cut, section, dissect
3 sēk-	to abate; lazy, quiet
1 seku̯-	to segue, follow
2 seku̯-	to see, notice; show, say, speak
1 sel-	salon, dwelling place
2 sel-, su̯el-	sill, beam, board
3 sel-	to grab, seize, take
4 sel-	to jump, leap, spring, exult
5 sel-	to creep, crawl
6 sel-, selə- : slā-	lucky, favorable; luck
selg̑-	to pour out, set free, send/throw away
selk-	to pull, drag; sulcus, furrow
selos-	sea, lake, swamp
selp-	salve, fat, butter
1 sem-	to draw, pour, scoop
2 sem-	one, some, together
3 sem-	summer
sēmi-	half, semi-
sen-, sene-, sen(e)u-, senə-	to prepare, work on
sendhro-	clotted, coagulated; fluid, melted, etc.
sengu̯-	to sink, sag, fall
sengu̯h-	to sing
seni-, senu-, seni-, sn̥-ter-	for oneself; sundry, separate
senk-	to singe, burn, dry
sen(o)-	old, senile, senior
sent-	to send, go, choose direction; to sense
sep-	to honor, care for, concern oneself with
septm̥	seven
1 ser-	to flow, stream
2 ser-	to serve, guard, protect, shelter
3 ser-, sor-	red
4 ser-	to insert, line up, put/bind together
5 ser-, extended serp-	sickle
serk-	to fence; hedge, plaited work
serp-	to creep, crawl
1 seu-, seu̯ə- : sū-	sop, soup, juice, liquid
2 seu-, seu̯ə-, sū̆-	to bear (a child); son
3 seu- : su-, seu̯ə- : sū-	to bend, turn
4 seu-, seu-t-	to seethe, boil
seug-	sad, sick, grievous, afflicted
seu̯ə-, sū-	to leave behind?
seu̯i̯o-	(to the) left
si̯ē[u]-ro- : si̯ə-ur(i̯o)-	brother-in-law
si̯ū-, sīu̯-	to sew
skabh-, skambh-	to support
(s)kāi-	bright, shining
(s)k(h)ai-, (s)k(h)ai-d-, (s)k(h)ai-t-	to cuff, kick
sk̑āi-, sk̑əi- : sk̑ī-	to shine/shimmer dully; shadow
(s)kamb-, and (s)kemb-	to bend, curve, hump
(s)kand-, (s)kend-	to glow; bright
(s)k(h)ed-, (s)k(h)e-n-d-	to crush, shatter, split to pieces
sk̑ed-	to cover
skē̆i-	to cut, skive, exscind, separate
skē̆i-bh-, nasalized ski-m-bh-	to limp; slanting
(s)kek-, skeg-	to jump, spring, move quickly; shake
1 (s)kel-	to cut, halve
2 (s)kel-	to owe, be guilty
3 (s)kel-	to parch, dessicate, dry out
4 (s)kel-, extended klā-, klō-	to bend; crooked
5 (s)ku̯el-, (s)kel-	to call, resound
(s)k̑el-	to jump, spring
skhel-	to stumble
(s)k̑em-	deformed, disabled, mutilated; hornless
(s)ken-(d-)	to skin, flay, split off
skendh-	to dive, plunge
(s)keng-	to hobble; lame, slanted
1 (s)kep-	to hide, cover
2 (s)kē̆p-, (s)kō̆p-, and (s)kā̆p-, (s)kē̆b(h)-, skob(h)-, and skā̆b(h)-	to cut, shave, split with sharp tool
1 (s)ker-	to shrink, dry out, wrinkle up; dry, thin
2 (s)ker-, skerə- : skrē-	to jump
3 (s)ker-	to bend, curve, turn
4 (s)ker-, (s)kerə-, (s)krē-	to cut, shear, score, scribe
5 (s)ker-	(onomatopoeic: hoarse sound)
(s)ku̯er-	to do, make
sk̑er-(d-)	to defecate; dung, excrement
(s)kerb(h)-, (s)kreb(h)-, nasalized (s)kremb-	to curve, turn
(s)ker-dh-, (s)kor-dh-	small, pitiful, miserable
(s)kert-s-	across, straight along
skēt- : skət-	to jump, spring
skēth-, skəth-	to scold, scathe, injure, damage
1 (s)keu-	to perform, carry out
2 (s)keu-, (s)keu̯ə : (s)kū-	to hide, wrap, cover
3 skē̆u-, ksē̆u-	to sneeze
4 (s)keu-	to notice, observe, pay attention to
5 skē̆u-	to push, shoot, throw
6 skēu(-t)-	to cut, scratch, separate
sk̑ē̆u-	to push, shoot, throw
skeub-, skeubh-, skeug-	to shove, move, shoot, throw
1 skeud-	to grumble, protest; unwilling
2 (s)keud-	to shoot, throw
(s)keup-, skeub(h)-	sheaf, bunch, flock, etc.
(s)keut-, (s)keudh-	to shrink, shrivel up
sk̑lēk-, sk̑lək-	to spray, sprinkle; wet
skordho-	pan, vessel; potsherd
skot-	shade, shadow, darkness
(s)kū̆t-	to shake, shudder
(s)ku̯alo-s	(type of large fish, e.g. whale)
sku̯erb(h)-	to pierce, stick (of thorns)
sk(h)u̯oi̯-, sk(h)u̯i(i̯)-	thorn, needle
(s)lā̆gu̯-	to grab, latch, seize
slak-	to hit, hammer
(s)leb-, (s)lob-, (s)lep-, (s)lop-	lip; to hang down slackly
(s)lēg- : (s)ləg-, and (s)leg-	weak, feeble, languid
slēgu̯-	to oppress, maltreat, mishandle
(s)leib-	to slip; slimy
(s)leidh-	to slide; slippery
(s)leig-	to hack, hit
slenk-, sleng-	to turn, wind; creep, slink
sler-	chasm
(s)leu-	slack, feeble, loosely hanging
sleub(h)-	to slide, slip
(s)leug-, (s)leuk-	to swallow
(s)leug̑-, (s)leuk̑-	to slide, slip
(s)leup-, (s)leub(h)-	to hang slackly
(s)lī- : sləi-, or slōi-, slī-u̯o-	livid, bluish
slougo-, slougā- (fem.)	help, service
(s)lr̥g-, and sler-	(onomatopoeic: to swallow)
sme, smā̆	really, truly (emphatic particle)
smē-, smeī-, sm-ei-	to rub, smear
smeg(h)-	to smack, taste
1 (s)mei-, smeu-	to smile
2 smēi- : sməi- : smī̆-	to carve, work with sharp tool
3 smēi-, smeid-, smēig-, smēik-	to rub, smear
smeit-, smit-	to throw
smek-	beard, chin
1 smel-	to smolder, burn slowly
2 smel-	gray
(s)mer-	to mourn, remember, think of, care for
smerd-, smord-	to stink
smeru-	fat, grease, smear
smeu-	to laugh, smile
(s)meukh-, (s)meug-, (s)meugh-	to smoke; smoke
smog-	heavy, burdensome
snā-, snə-(t-), snāu-, sn-eu-, sn-et-	to flow, swim; damp
(s)nadh-	to cut, slice
(s)nē-, and (s)nēi-	to spin, twist threads together
(s)nēbh-ri-, (s)nōbh-ri-	thin, narrow
sneig-	to crawl, snake
sneigu̯h-	to snow; snow
sneit-	to cut
snēp-, snōp-, snəp-	to gather in sheaves/bundles; twist into rope
1 (s)ner-, (s)nur-	to snarl, growl
2 (s)ner-	to turn, wind, etc.
(s)nerb-	to cut?
sneu-	to flow, swim; damp
snēu- : snū-, and snĕu-	to turn, bind, attach; band, sinew
sneubh-	to woo, marry
1 sneud(h)-	to drowse, slumber; drowsy, sleepy
2 sneudh-	fog, mist
snusós	daughter-in-law
so(s), sā	(nom. sg. demonstrative stem: he, she)
soi-to-	magic
solo-, sol(e)u̯o-	whole, well-kept, salubrious
sō[u]rā : sōrā	calf (of leg)
spako-	point; small drop
sp(h)ē-, sp(h)ə-(dh-)	long flat piece of wood
speg̑-, or spō̆g̑-	to watch sharply, be attentive
1 (s)p(h)ē̆i- : (s)p(h)ī̆-	sharp/pointed stick: spile, spit, etc.
2 sp(h)ei : sp(h)ī̆, and sp(h)ē : sp(h)ə-	to pull, drag
3 sp(h)ē(i)-, spī-, and sphē- : sphə-	to fatten, prosper, succeed, etc.
spek̑-	to watch, inspect, spy on
(s)pel-	to speak aloud, tell with emphasis
1 (s)p(h)el-	to cut, split, spall, tear off; board
2 (s)p(h)el-	to shine, glitter
(s)p(h)elg-	to split, splinter
sp(h)elg̑h(en), spleng̑h-, splē̆g̑h-	milt; spleen
1 (s)pen(-d)-	to pull, spin
2 *(s)pen-, (s)pon-, (s)pondho-	wooden pail
spend-	to offer a libation
sp(h)e(n)d-	to shake, quiver
sp(h)eng-	to shine, glitter
speno-, stē̆no-, p(ə)stē̆no-	teat, breast, nipple
1 (s)per-	pole, spar, rafter
2 sper(-g)-	(type of bird, esp. sparrow)
3 sper-	to turn, wind
4 (s)p(h)er-, (s)p(h)erəg-	to rip, tear; rag, snippet
1 sp(h)er-, sp(h)erə-	to rush, push away, act rashly, etc.
2 (s)p(h)er-, sprei-, spreu-	to sow, strew, spread, scatter, sprinkle
3 sp(h)er-	balls of goat/sheep excrement
sp(h)erd(h)-, (s)p(h)red(h)-, nasalized sp(h)rend(h)-	to rush, sprint, spring; running
*(s)p(h)ereg-, (s)p(h)erəg-, (s)p(h)rēg-, nasalized spreng-	to rush, hurry; strew, sprinkle, disperse
sperg̑h-, spreg̑h-, nasalized spreng̑h-	to rush, hurry, spring, jump
(s)p(h)eu-d-	to press, hurry
(s)pī̆ko-	woodpecker (or other large bird)
(s)pingo-	finch, sparrow
(s)p(h)i̯ēu- : (s)pi̯ū-, (s)pīu̯-	to spit, spew, sputter
(s)plei-	to cut, split
(s)pleig̑h-	to splay (legs)
(s)poimno-	foam, spume, spray
sprei-, spreu-	to sow, strew, scatter
sp(h)reig-	to teem, abound, overflow
sraku̯-to-	sharp-edged
srebh-, sr̥bh-, and serbh-	to sip, slurp, swallow
sr-edh-, sr-et-	to boil, spout, whirl
(s)reigh-	to creep, climb, clamber
srenk-	to snore
srēno-	body part (e.g. hip, loins)
sresk-	to drip, drizzle
sreu-	to stream, flow
sreup-	dirty, scabby
srīg-, srīgos-	cold, frost
srō̆mo-	lame
stā- : stə-	to stand
stag-	to drip, drizzle, trickle
(s)tāi-	to steal, do secretly
stāi-, stī̆-, sti̯-ā-	to condense, press together; stiff; stone
stāk-, stek-	to place, stand
steb(h)-, and stēb(h)- : stəbh-, nasalized stemb(h)-, step-, also stēp-?, nasalized stemp-, nominal stəbho-s, stemb(h)ro-s, stomb(h)o-s	stump, post, pillar; to support, etc.
1 (s)teg-	to deck, thatch, cover; house, roof
2 (s)teg-	stake, pole, beam
stegh-, nasalized stengh-	stick, stalk, stang, etc.
(s)tei-	sharp, pointed; spike, style, stylus
stē̆ib(h)-, stī̆b(h)-, stē̆ip-, stī̆p-	stick, pole, stake; stiff
(s)teig-	to stick, prick; sharp
steigh-	to climb, ascend; stride, march
(s)teigu̯-	arm, shoulder; thigh, hip
(s)teigu̯h-	to endure, wait patiently
1 (s)tel-	to urinate, let flow
2 stel-, stelə-	to dilate, broaden, stretch out; broad
3 stel-	to put, place
stem-	to push, thrust; stumble, stutter
1 (s)ten-	to drone, groan, thunder, etc.
2 sten-	to narrow, hem in
1 (s)ter-, (s)terə- : (s)trē-	stark, stiff, solid, rigid, etc.
2 stē̆r-	star
3 ster-	to rob, steal
4 ster-, also sterə- : strē-, strei-, streu-	line, streak, strip, stripe
5 ster-, sterə- : strē-, steru- : streu-	to strew, scatter, spread out
6 ster-	barren, sterile, unfruitful
7 (s)ter-n-	thorn, prickly stalk
8 (s)ter-	dung, stercory, dirty water; to rot, befoul
sterg-, sterk-	to care for, pay careful attention to
1 (s)teu-	to hit, push, thrust
2 steu-	to praise (aloud)
steu̯ə-	to coagulate, become dense/thick
stilp-, stilb-	to shine; to look, show
stomen-	mouth, stoma
storos, stornos, str̥nos?	starling, songbird
1 streig-	to halt, pause, falter, be(come) stuck
2 streig-	taut, stiff, strict; to twist; rope
3 (s)treig-, streid(h)-	to hiss
strenk-, streng-	tight, cramped; cord, string
(s)trep-, (s)treb-	to cry, make wild noises
stru-	gray-haired, old (man)
su-, sū-	good, well
sū̆-s, suu̯-ós	pig, sow, swine
sū-ro-, sou-ro-	sour, bitter, salty; cheese
1 sūs-	to whistle (of wind)
2 sūs-	parent, creator, producer
su̯ād-	sweet; to enjoy something
su̯ard-	to laugh
su̯ei-, su̯i-	to pipe, whistle, sibilate
su̯ē̆(i)-	to bend, turn, swing, swivel
1 su̯eid-	to shine, glisten
2 su̯eid-	to sweat, perspire; sweat
su̯ēid-	milk
su̯ek-	to smell (good)
su̯ekrū́-	husband's mother
su̯ek̑s, sek̑s, ksek̑s, ksu̯ek̑s, u̯ek̑s : uk̑s	six
s(u̯)eku̯o-s	sap, pitch, resin
1 su̯el(-k)-	to eat, drink, swill, swallow
2 su̯el-	to burn, smolder, swelter
3 su̯el-, su̯ol-, sul-	sole of foot; ground
4 su̯el-	beam, board
su̯e-lo-, su̯elii̯o(n)-	brother-in-law
su̯elplo-s	sulphur
su̯em-	to swim, move
su̯en-	to sound, resound
(s)u̯endh-	to dwindle, disappear
su̯eng-, su̯enk- : su̯eg-, su̯ek-	to bend, swing, swag
su̯enk-, sunk-	heavy; pregnant
su̯ento-, sunto-	sound, active, healthy, vigorous
1 su̯ep-, sup-	to sleep
2 su̯ep-, sup-, su̯eb-	to throw
1 su̯er-, also ser-?	to speak, swear, answer
2 su̯er-	to buzz, hiss
3 su̯er-	stake
4 su̯er-	to cut, prick, pierce
5 su̯er-	heavy
su̯erbh-, also su̯er-?	to turn, sweep, swerve
su̯ergh-	to be ill; to sorrow, care for
su̯esor-	sister
su̯ī-	to fade, dwindle, become silent
su̯omb(h)o-s	porous, spongy, swampy
su̯ordo-s	black, swarthy; dark/dirty color
tā-, tə-, tāi-, təi-, tī̆-; [tāu-], təu-, tū̆-	to thaw, melt, decay, dissipate
tād-	to act purposefully
tag-, or teg- : tog- : teg-	to grip, seize, touch
tāg-	to tidy up
tak-, takē(i)-	to be tacit, silent
tāl-	to grow, turn green; plant, young sprout
1 tap-	to dip
2 tap-	to press down/together
tata-, and similarly tē̆ta-	daddy (nursery word)
taus-	calm, still, silent, peaceful
teg-	to cover
tēg-, təg-	to burn
tegu-	thick, fat
tei-	sharp, pointed; spike
teig-	to prick, stick; sharp
teigu̯-	arm, shoulder; thigh, hip
1 tek-	to bear, produce
2 tek-	to reach, stretch out (hand) for
3 tek-	to plait, weave
tek̑þ-	to plait
teku̯-	to flow, run
1 tel-, telə-, tlē(i)-, tlā-	to bear, carry; weigh, lift up
2 tel-, telə-, telu-	flat (board, ground)
3 tel-	to be calm/still
4 tel-	to urinate, let flow
teleg̑h-	to hit
telek-	to hit, push
telp-	to have room; spacious
1 tem-, tend-	to cut
2 tem-	stunned, confused
tem(ə)-	dark
temp-	to span, stretch, extend
1 ten-, tend-	to span, stretch, extend
2 ten-	to drone, groan, thunder, etc.
tend-	to cut
tenəgos, tenəgos	ground (under water)
1 teng-	to dunk, soak, wet
2 teng-	to feel, think
tengh-	to span, extend; pull, stretch
1 tenk-	to span, extend; pull, stretch
2 tenk-	to clot, thicken, contract; tight, solid
tens-	to span, stretch, extend
tenu-s, tenu-s	thin
tep-	to be warm, tepid
1 ter-	to quiver, tremble
2 ter-, teru-	weak, feeble, tender, fragile
3 ter-, terə-, and teri-, trēi-, trī-, also teru- : treu-	to bore, drill, rub, thresh
4 ter-, terə- : tr̥̄-, trā-, teru-	to cross, get over, etc.
5 ter-	through, over, etc.
6 ter-	(boring/gnawing insect)
7 ter-, terə-, terbh-, terd-, terg-, terp-	stiff, rigid, solid, etc.
terd-, tred-	to bore, drill through
tergu̯-	to warn, threaten; fright, horror
terk-, trek-, tork-, trok-	to torque, turn
terp-, trep-	to enjoy, satisfy oneself
ters-	to toast, dry; thirst
tet(e)r-	(onomatopoeic: to quack)
1 teu-, teud-, teug-, teuk-, teup-	to hit, push, thrust
2 teu-	to notice, observe, listen to
tēu-, təu-, teu̯ə-, tu̯ō-, tū̆-	to swell, intumesce
teuk-	germ, seed, sprout, offspring
teup-	to crouch down, conceal oneself
teus-	to empty
teu̯ə-, tu̯ā-	to sift
ti-ti-, (ti)til-	(onomatopoeic: chirping of small bird)
ti̯egu̯-	to retreat, step back in fear; shy
1 to-, tā-, ti̯o-	that, him (neut. or non-nom. demonstrative stem)
2 to-	(prefix)
tolku̯-	to speak
1 tong-, *teng-	to think, feel
2 tong-	to touch, grip, seize
top-	to reach, stay; place
tor-, toro-s	loud, distinct, audible
trāgh-, trō̆gh-, and trē̆gh-	to drag, train, pull, move
trē̆b-, trōb-, treb-, or trəb-, tr̥b-	building, dwelling
treg-	to make an effort, use all one's strength; battle, force; solid
trei-	three, trio
treig-	to hiss
treisti-, or trīsti-	sulky, moody, stubborn
trek-	to pull, run
trem-, trems-	to shake, tremble; to stomp, trample
1 trenk-	to throng, push, press together
2 trenk-	to wash, bathe, cleanse
1 trep-	to trip, tread, trample
2 trep-	to bow the head, turn away in shame
3 trep-, treb-	to cry, make wild noises
tres-, ters-, *teres-	to quiver, tremble
trē̆u-	to prosper
tr-eu-d-	to thrust, push, press, squash
trii̯əto-, trīto-	sea; wet, watery
tris-	vine; stem, stalk
trozdos- : tr̥zdos-	thrush, blackbird
trū̆des-	scratchy; leprosy?
truk̑-	to cut
trus-	reed
tu, tutu	(onomatopoeic: chirping of bird)
tū̆	thou, you
tū-lo-	slow, lazy, sluggish; boring
1 tu̯ā̆k-, tuk-	to bind, close up, pull together
2 tu̯ak-	to bathe
tu̯akos	skin
1 tu̯ē̆i-	to hack, hew, cut down, hit sharply
2 tu̯ei-, extended tu̯ei-s-	to shake, excite, move back and forth, shimmer
tu̯en-	to hit, push, thrust
tu̯eng̑h-	to twinge, oppress, constrain, close in
1 tu̯er- : tur-, and tu̯r̥-	to twirl, turn
2 tu̯er- : tur-, tu̯erə-	to grab, hold
tu̯erk̑-	to cut
tu̯ī̆bh-	hollow
tu̯ō[u]- : tu̯əu- : tū-l-	pipe, tube
1 u-	(onomatopoeic: owl's hoot, etc.)
2 u-	ooh! (interjection of pain)
ub-	to drag, press down
ū̆d-	out, away, up(wards)
udero-, u̯ēdero-	belly, uterus
ul-	(onomatopoeic: to howl, ululate)
upér, upéri	over, above
upo, up, eup, (e)up-s-	under, (from) below, etc.
1 u̯ā-, u̯ō-, u̯ə-	to hit, wound
u̯en-	to hit, wound
2 u̯ā-	(to pull) apart
u̯āb-	to call, cry, weep, lament
u̯adh-	pledge
u̯ādh-, u̯ədh-	to go, wade, stride, march
1 u̯ā̆g-	sheath, cover, hollow lid
2 u̯ā̆g-	to cry, shriek
u̯ā̆gh-, suā̆gh-	to cry, shriek, sough
u̯ai	woe; wolf
u̯ā̆i-, u̯ī-	weak, miserable
u̯ā̆kā	cow
u̯al-, u̯al-d(h)-	to prevail, be strong
u̯ank̑-	beam
1 u̯ap-	to chatter
2 u̯ap-, ū̆p-	to call, cry
u̯āsto-s	to lack; empty
1 u̯āt-, better u̯ōt-	wood, vatic, mentally animated
2 u̯ā̆t-	to bend, curve
u̯azdh-, better u̯ozdh-	long, wide
1 u̯ē̆-, u̯ei-	we two (dual), we (plural)
2 u̯e-, u̯edh-	to weave
3 u̯ē-, u̯ə-	to blow
4 u̯e-, u̯o-, u̯es-	from, away, downward
5 u̯e-, u̯o-	other; that (one)
1 u̯ebh-	to plait, weave, waver, move back and forth
2 u̯ebh-	to roam, swarm, wander
u̯ed-	to lead
1 u̯edh-	to hit, push
2 u̯edh-, before nasals u̯ed-	to lead
3 u̯edh-	to tie, bind, attach
u̯eg-	to bind, weave
u̯eg̑-	fresh, strong
u̯egu̯- : ū̆gu̯-, uku̯s-	damp, moist; to wet, sprinkle, irrigate; ox
u̯eg̑h-	to move, drive, carry, convey
u̯əg- : u̯āg-	bent, curved
1 u̯ei-, u̯ei̯ə- : u̯ī̆-	to bend, turn, wind
2 u̯ei-, u̯ei̯ə- : u̯ī̆-	to wizen, wither
3 u̯ei-, u̯eiə- : u̯ī-	to wish, pursue, go for, reach towards; strong, violent
u̯eib-	to sway, turn
1 u̯eid-	to bend, turn
2 u̯(e)id-	to vide, see, wit, know
u̯eidh-, u̯idh-	to divide, separate; widow
1 u̯eik-	to choose, filter, sort out
2 u̯eik-	force, energy (in battle, victory, etc.)
3 u̯eik-	to happen, become equal, come together
4 u̯eik-, u̯eig-, extended form of u̯ei-	to bend, curve; exchange, pass around
u̯eik̑-, u̯ik̑-, u̯oik̑o-	house, village, settlement
u̯eip-, u̯eib-	to turn, whip, sway, vibrate
1 u̯eis-	to grow, sprout
2 u̯eis-	to bend, turn
3 u̯eis-	to flow (away); ooze, virus, poison
u̯ek-, u̯e-n-k-	to bend
u̯ək- : *u̯āk-	bent
u̯ek̑-	to want, wish
u̯eku̯-	to voice, speak, evoke
u̯ek-ti-	whit, thing
1 u̯el-	to see
2 u̯el-, u̯lei-, u̯lē(i)-	to will, want, wish, choose
3 u̯el-	to crowd, press, push
4 u̯el-, u̯elə-	wool, hair; grass, wold, forest
5 u̯el-, u̯elə-	to deceive
6 u̯el-	warm
7 u̯el-, u̯elə-, u̯lē-	to turn, wind; round, voluble
8 u̯el-	to steal; to wound, tear, avulse
1 u̯elk-	to pull, drag
2 u̯elk-, u̯elg-	wet, damp
u̯em-, u̯emə-	to spit, spew, wamble, vomit
1 u̯en-, u̯enə-	to love, venerate, strive/wish for
2 u̯en-	to hit, wound
1 u̯endh-	to turn, wind, wend
2 u̯endh-	to wane, disappear
3 u̯endh-	hair, beard
u̯e-n-g-	bent
u̯e-n-gh-	bent
u̯e-n-k-	bent
1 *u̯ep- : u̯ō̆p- : up-	water
2 u̯ep-	to strew, throw out
u̯ēp- : u̯əp-	to blow; to soar
1 u̯er-, also su̯er-	to bind, attach; strive
2 u̯er-	highland, raised place; high, top
3 u̯er-	to bend, turn, wrap
3a u̯er-, u̯r̥mi-s, u̯r̥mo-s	worm
3b u̯er-, u̯er-b-, and u̯er-bh-	to bend, turn, warp
3c u̯er-, u̯(e)r-ed-	to sway, bend down
3d u̯er-, u̯er-g-	to turn, wrench
3e u̯er-, u̯er-g̑h-	to turn, press, wring, strangle
3f u̯er-, u̯er-k-	to bend, turn, wind
3g u̯er-, u̯er-p-, u̯r-ep-	to turn, wind
3h u̯er-, u̯er-t-	to turn, wind, invert
3i u̯er-, u̯r-ei-	to clench the teeth; wroth, confused
4 u̯er-	to find, take
5 u̯er-	to shut, close, cover; guard, warn, save
6 u̯er-	to speak, talk formally
7 u̯er-	to root, open, tear up
8 u̯er-	to notice, observe, attend, be aware
9 u̯er- : u̯eru-s	wide, broad
10 u̯er-	to flow; wet; water, river, etc.
11 u̯er-, u̯erə-	to show friendship; true, very, veracious, trustworthy
12 u̯er-	to burn
13 u̯er-	squirrel, weasel, etc.
u̯(e)rād-, u̯erəd-, u̯rəd-	root, branch, twig
u̯erdh-, u̯redh-	to grow; high
1 u̯erg̑-, u̯reg̑-	to (en)close, shut off; pen
2 u̯erg̑-, u̯reg̑-	to do, work, be effective
3 u̯erg̑-, u̯org̑-	to abound, be very strong; to swarm, swell
u̯er-g-, u̯er-g̑h-, u̯er-k-	to bend, turn
u̯er-(e)nā	alder, poplar
u̯ers-	to drag along the ground
u̯eren-	lamb, ram, sheep
1 u̯es-	to live, stay overnight
2 u̯es-	to feast
3 u̯es-	to ooze, dampen; wet
4 u̯es-	to stick, stab, pierce
5 u̯es-	to dress, clothe, wear
6 u̯ē̆s-	you (plural)
7 u̯es-	to turn, wind, wrap
8 u̯es-	to buy, sell, exchange
u̯es-no-	price
9 u̯es-	to shine
u̯esperos, u̯ekeros	vesper, evening
u̯es-r̥	spring
u̯ē̆su-	good
u̯et-	year
1 u̯ī̆-	apart, separate from, in two; both
2 u̯ī̆-, u̯oi-	(onomatopoeic root)
u̯idhu-	tree, wood
u̯ī-k̑m̥t-ī	twenty
u̯ī̆ks-	mistletoe, tree with sticky(?) sap
u̯ing̑-, and u̯eig̑-, u̯ig̑-?	elm (tree)
u̯ī̆ro-s	man, warrior
u̯i̯eth-, u̯ith-	to shake
u̯lek-, u̯l̥k-	to light, shine; fiery
u̯l̥ku̯os	wolf, lobo
u̯l̥p-, lup-	(carnivorous animal, esp. fox, wolf, etc.)
u̯obhsā	wasp
u̯ogu̯hni-s, u̯ogu̯hnes-	plowshare
u̯okso-	wax
u̯ōro-	madness; dizziness, weariness
u̯ortoko-	quail
1 u̯rā̆g̑h- : u̯rəg̑h-	spike, thorn
2 u̯rāg̑h- : u̯rəg̑h-	to hit, push
u̯reg-, and u̯erg-?	to drag, push, drive, thrust
u̯rēg̑-, u̯rōg̑-, u̯rəg̑-	to break
u̯rek-	to speak, talk formally
u̯reik-, u̯ereik-	heather
u̯ren-	to splash, sprinkle
u̯reth- : u̯roth-, or u̯rath-	to support
u̯rughi̯o-	rye